,Unnamed: 0,Unnamed: 0.1,날짜,종가,대비,거래량,기관 매수,기관 매도,기관 순매수,외국인 매수,외국인 매도,외국인 순매수,개인 순매수,개인 매수,개인 매도,개인매수비율(%),개인매수비율증가(%p),개인매도비율(%),개인매도비율증가(%p),개인 순매수비율,기관 순매수비율,외국인 순매수비율
15,233,233,2019-12-02,1258000.0,-7000.0,25534,9955,7529,2426,12922,16725,-3803,1377,2657,1280,10.405733531761573,2.589270538909372,5.0129239445445295,0.009465332600790077,5.392809587217044,9.501057413644553,-14.893867000861595
16,232,232,2019-12-03,1266000.0,8000.0,17348,6651,9547,-2896,9341,6933,2408,488,1356,868,7.816462992852203,-1.7089979631619023,5.0034586119437385,-3.839960843579063,2.813004380908462,-16.693566981784645,13.880562600876182
17,231,231,2019-12-04,1260000.0,-6000.0,17301,7301,7256,45,8352,8515,-163,118,1648,1530,9.525460956014104,-5.954175182088026,8.843419455522803,4.289977239273061,0.6820415004913011,0.2601005722212589,-0.94214207271256
18,230,230,2019-12-05,1249000.0,-11000.0,19348,8315,5857,2458,8038,12610,-4572,2114,2995,881,15.479636138102133,12.887180062417155,4.553442216249741,-10.171954024074624,10.926193921852386,12.704155468265453,-23.630349390117846
19,229,229,2019-12-06,1267000.0,18000.0,16278,5432,6309,-877,10424,7572,2852,-1975,422,2397,2.5924560756849733,-5.069760099159826,14.725396240324367,5.0944752436409715,-12.13294016463939,-5.387639759184174,17.520579923823565
20,228,228,2019-12-09,1267000.0,0.0,23518,7420,8420,-1000,14296,12833,1463,-463,1802,2265,7.662216174844799,1.7222459606163651,9.630920996683393,5.140143129802878,-1.968704821838592,-4.252062250191344,6.2207670720299335
21,227,227,2019-12-10,1265000.0,-2000.0,17458,4230,3821,409,12191,12853,-662,253,1037,784,5.939970214228432,-14.50425168211979,4.490777866880514,1.00352868057199,1.449192347347921,2.3427654943292477,-3.791957841677168
22,226,226,2019-12-11,1255000.0,-10000.0,27959,10046,7983,2063,12197,19001,-6804,4741,5716,975,20.444221896348225,17.708713446174354,3.4872491863085235,-9.556806897152173,16.9569727100397,7.378661611645623,-24.33563432168533
23,225,225,2019-12-12,1277000.0,22000.0,45147,27006,24554,2452,16906,14704,2202,-4654,1235,5889,2.735508450173876,-34.19796035930564,13.044056083460696,3.5688353384372977,-10.308547633286821,5.4311471415597925,4.877400491727026
24,224,224,2019-12-13,1246000.0,-31000.0,69877,23221,15976,7245,20848,47280,-26432,19187,25808,6621,36.93346880947952,33.40845468334399,9.475220745023398,-23.84507307859549,27.458248064456114,10.368218440974855,-37.82646650543097
25,223,223,2019-12-16,1272000.0,26000.0,46014,21185,7272,13913,23207,23410,-203,-13710,1622,15332,3.5250141261355243,-3.1016599810073333,33.3202938236189,14.308714582547472,-29.795279697483373,30.236449776155087,-0.4411700786717086
26,222,222,2019-12-17,1279000.0,7000.0,28672,10548,9278,1270,16224,13943,2281,-3551,1900,5451,6.626674107142858,-12.285723014415293,19.011579241071427,11.944745958010282,-12.384905133928573,4.429408482142857,7.9554966517857135
27,221,221,2019-12-18,1269000.0,-10000.0,23207,7930,10041,-2111,10888,11526,-638,2749,4389,1640,18.91239712155815,2.5027734324773334,7.066833283061143,-0.5780203210768518,11.845563838497007,-9.096393329598829,-2.7491705088981773
28,220,220,2019-12-19,1266000.0,-3000.0,21073,9541,7211,2330,8074,12251,-4177,1847,3458,1611,16.409623689080814,4.7070029010615615,7.644853604137998,-2.356929244854693,8.764770084942818,11.056802543539126,-19.821572628481945
29,219,219,2019-12-20,1273000.0,7000.0,28045,7152,8753,-1601,17611,16487,1124,477,3282,2805,11.702620788019257,-14.778434267454893,10.00178284899269,1.7696287773996406,1.7008379390265644,-5.7086824745944025,4.007844535567838
30,218,218,2019-12-23,1262000.0,-11000.0,19108,9416,7141,2275,4632,10394,-5762,3487,5060,1573,26.481055055474144,7.174384386906574,8.23215407159305,-7.217684601776801,18.248900983881093,11.906007954783338,-30.15490893866443
31,217,217,2019-12-24,1259000.0,-3000.0,13327,7347,4931,2416,3407,6337,-2930,514,2573,2059,19.30667066856757,-6.268721888971688,15.449838673369849,-6.970753568689371,3.8568319951977186,18.12861109026788,-21.985443085465604
32,216,216,2019-12-26,1257000.0,-2000.0,13947,7896,5213,2683,2484,5607,-3123,440,3567,3127,25.57539255753925,2.208301597769676,22.420592242059218,9.064650590103447,3.154800315480032,19.237111923711193,-22.391912239191228
33,215,215,2019-12-27,1258000.0,1000.0,21526,9940,13122,-3182,6556,5529,1027,2155,5030,2875,23.367090959769573,17.950170691966782,13.355941651955776,-1.5287543648157147,10.011149307813806,-14.78212394313853,4.770974635324722
34,214,214,2019-12-30,1261000.0,3000.0,14787,9185,2237,6948,4801,10349,-5548,-1400,801,2201,5.4169202678028,-10.5005447285126,14.884696016771489,-9.0201594650921,-9.46777574896869,46.987218502738884,-37.519442753770214
35,213,213,2020-01-02,1266000.0,5000.0,24426,12539,11744,795,7999,6843,1156,-1951,3888,5839,15.9174649963154,-0.30468104413712105,23.90485548186359,0.5383830787096606,-7.987390485548186,3.25472856791943,4.732661917628755
36,212,212,2020-01-03,1263000.0,-3000.0,29170,13989,16123,-2134,10449,6231,4218,-2084,4732,6816,16.222146040452518,-12.449638795715876,23.36647240315393,13.958072583795204,-7.144326362701405,-7.315735344532054,14.46006170723346
37,211,211,2020-01-06,1249000.0,-14000.0,19929,7601,10422,-2821,6614,7632,-1018,3839,5714,1875,28.6717848361684,19.349791429890022,9.408399819358722,-59.63455493242111,19.263385016809675,-14.155251141552514,-5.108133875257163
38,210,210,2020-01-07,1343000.0,94000.0,62787,26970,13038,13932,29964,6399,23565,-37497,5853,43350,9.32199340627837,-5.591054072558583,69.04295475177983,48.65051824092227,-59.72096134550146,22.189306703616992,37.53165464188447
39,209,209,2020-01-08,1345000.0,2000.0,43472,29708,17107,12601,7281,17500,-10219,-2382,6483,8865,14.913047478836953,-0.9928666292268656,20.392436510857564,13.656522884791146,-5.479389032020611,28.98647405226352,-23.507085020242915
40,208,208,2020-01-09,1324000.0,-21000.0,41494,16742,11767,4975,18152,26932,-8780,3805,6600,2795,15.90591410806382,0.24763074638835114,6.73591362606642,-17.957543815981378,9.170000481997397,11.98968525569962,-21.159685737697014
41,207,207,2020-01-10,1343000.0,19000.0,22346,11438,10905,533,7409,5923,1486,-2019,3499,5518,15.658283361675467,0.4223837479320149,24.6934574420478,-3.847059049691172,-9.035174080372324,2.3852143560368746,6.649959724335451
42,206,206,2020-01-13,1404000.0,61000.0,49449,21278,10599,10679,20637,24737,-4100,-6579,7534,14113,15.235899613743452,2.168323849829872,28.540516491738966,18.206506912754172,-13.30461687799551,21.59598778539505,-8.291370907399543
43,205,205,2020-01-14,1411000.0,7000.0,47813,10494,12020,-1526,31071,30852,219,1307,6248,4941,13.06757576391358,7.108548456571668,10.334009578984793,-2.0886118324006624,2.733566184928785,-3.1916006107125683,0.4580344257837827
44,204,204,2020-01-15,1422000.0,11000.0,42809,10141,12461,-2320,30117,25030,5087,-2767,2551,5318,5.9590273073419135,-8.225284891286378,12.422621411385455,7.855248923440325,-6.463594104043543,-5.419421149758228,11.883015253801773
45,203,203,2020-01-16,1405000.0,-17000.0,33389,8361,9250,-889,20292,22614,-2322,3211,4736,1525,14.184312198628293,6.564805808897197,4.567372487945132,-2.7574412039309832,9.61693971068316,-2.6625535355955554,-6.954386175087604
46,202,202,2020-01-17,1406000.0,1000.0,35291,11723,11731,-8,20879,20975,-96,104,2689,2585,7.619506389731092,-5.499789926926413,7.324813691876116,-2.2276876825054126,0.2946926978549772,-0.02266866906576748,-0.2720240287892097
47,201,201,2020-01-20,1387000.0,-19000.0,45475,15622,19895,-4273,23887,21236,2651,1622,5966,4344,13.119296316657506,-7.0594393385066345,9.552501374381528,3.9185296042187865,3.566794942275976,-9.396371632765256,5.829576690489278
48,200,200,2020-01-21,1343000.0,-44000.0,50018,14844,13382,1462,25081,33818,-8737,7275,10093,2818,20.178735655164143,15.258686454672134,5.6339717701627405,-5.364388213437094,14.5447638850014,2.9229477388140266,-17.467711623815426
49,199,199,2020-01-22,1368000.0,25000.0,39024,14112,8327,5785,22992,26405,-3413,-2372,1920,4292,4.920049200492005,-6.2801567074829725,10.998359983599837,5.256695296817544,-6.078310783107831,14.824210742107422,-8.74589995899959
50,198,198,2020-01-23,1349000.0,-19000.0,50508,13480,19111,-5631,31371,28497,2874,2757,5657,2900,11.200205907974977,-15.110736067471112,5.741664686782293,-2.115384188251867,5.458541221192681,-11.148728914231407,5.690187693038727
51,197,197,2020-01-28,1253000.0,-96000.0,98803,23219,46356,-23137,49588,44684,4904,18233,25996,7763,26.31094197544609,18.431095079123907,7.8570488750341605,-6.2929382654672095,18.453893100411925,-23.4173051425564,4.963412042144469
52,196,196,2020-01-29,1296000.0,43000.0,132198,29753,46909,-17156,92028,66583,25445,-8289,10417,18706,7.879846896322182,-12.851558062355506,14.149987140501368,10.630703393944897,-6.270140244179187,-12.977503441806984,19.24764368598617
53,195,195,2020-01-30,1262000.0,-34000.0,72600,10871,31625,-20754,46678,38420,8258,12496,15051,2555,20.731404958677686,6.753486852319213,3.5192837465564737,-2.668412349396504,17.21212121212121,-28.586776859504127,11.37465564738292
54,194,194,2020-01-31,1258000.0,-4000.0,50358,10504,17258,-6754,32815,29984,2831,3923,7039,3116,13.977918106358473,-5.914985717902606,6.187696095952978,-3.368740215553537,7.790222010405498,-13.41197029270424,5.621748282298741
55,193,193,2020-02-03,1250000.0,-8000.0,47434,20222,16724,3498,17776,26177,-8401,4903,9436,4533,19.89290382426108,2.7841683051842807,9.556436311506516,-2.5538647127811807,10.336467512754565,7.37445714044778,-17.710924653202344
56,192,192,2020-02-04,1269000.0,19000.0,44714,11643,18695,-7052,25421,20604,4817,2235,7650,5415,17.1087355190768,6.642313800358693,12.110301024287695,-11.596918136085167,4.9984344947891035,-15.771346781768573,10.772912286979471
57,191,191,2020-02-05,1302000.0,33000.0,58788,11534,22286,-10752,41101,22565,18536,-7784,6153,13937,10.466421718718106,3.668676160915756,23.707219160372862,-0.9754810074195888,-13.240797441654761,-18.289446825882834,31.530244267537594
58,190,190,2020-02-06,1354000.0,52000.0,69729,21115,13304,7811,43874,39214,4660,-12471,4740,17211,6.797745557802348,0.8859167520089297,24.68270016779245,16.292879839338454,-17.884954609990107,11.201938935019863,6.683015674970242
59,189,189,2020-02-07,1352000.0,-2000.0,58273,14432,16645,-2213,40396,36739,3657,-1444,3445,4889,5.91182880579342,-0.3747117109602103,8.389820328454,-7.0656395319848,-2.4779915226605804,-3.797642132720128,6.275633655380707
60,188,188,2020-02-10,1356000.0,4000.0,31814,7095,8787,-1692,22719,18110,4609,-2917,2000,4917,6.286540516753631,2.1788036931510453,15.4554598604388,-4.7316733773448085,-9.16891934368517,-5.318413277173573,14.48733262085874
61,187,187,2020-02-11,1382000.0,26000.0,36979,12154,7046,5108,23306,22468,838,-5946,1519,7465,4.107736823602585,-1.4132939607628918,20.18713323778361,3.7512093469085457,-16.079396414181026,13.813245355472025,2.266151058708997
62,186,186,2020-02-12,1398000.0,16000.0,41677,14336,8772,5564,25040,26055,-1015,-4549,2301,6850,5.521030784365476,1.0996436091925483,16.435923890875067,6.850019983602675,-10.914893106509586,13.350289128296184,-2.435396021786597
63,185,185,2020-02-13,1403000.0,5000.0,42792,15454,17800,-2346,25446,20890,4556,-2210,1892,4102,4.421387175172929,-3.4930182328057438,9.585903907272387,2.909240096932484,-5.164516732099458,-5.482333146382501,10.646849878481962
64,184,184,2020-02-14,1389000.0,-14000.0,42012,7928,10104,-2176,30759,29103,1656,520,3325,2805,7.914405407978673,4.047556997045319,6.676663810339902,-4.999209638257557,1.2377415976387698,-5.179472531657622,3.941730934018852
65,183,183,2020-02-17,1397000.0,8000.0,27878,11142,9627,1515,15658,14996,662,-2177,1078,3255,3.8668484109333523,-2.0473323130040333,11.67587344859746,5.101989591070188,-7.8090250376641075,5.434392711098356,2.374632326565751
66,182,182,2020-02-18,1390000.0,-7000.0,34561,12469,13681,-1212,20048,18608,1440,-228,2044,2272,5.9141807239373865,0.9120917725909612,6.573883857527273,-17.718721254706388,-0.6597031335898845,-3.5068429732935966,4.166546106883482
67,181,181,2020-02-19,1410000.0,20000.0,26329,14137,10263,3874,10875,9670,1205,-5079,1317,6396,5.002088951346424,-12.509087129291332,24.29260511223366,17.297993427917568,-19.29051616088724,14.7138136655399,4.576702495347336
68,180,180,2020-02-20,1372000.0,-38000.0,58831,13824,23075,-9251,34705,31641,3064,6187,10302,4115,17.511176080637757,3.9886870293913614,6.994611684316093,0.16383478981848842,10.516564396321668,-15.724702962723734,5.2081385664020665
69,179,179,2020-02-21,1364000.0,-8000.0,48179,9722,16897,-7175,31942,27991,3951,3224,6515,3291,13.522489051246396,-18.723770134776093,6.830776894497602,-1.2824362212241454,6.691712156748791,-14.892380497727224,8.200668340978433
70,178,178,2020-02-24,1278000.0,-86000.0,67766,19294,20992,-1698,26620,41276,-14656,16354,21852,5498,32.246259186022485,16.758191179338628,8.113213115721749,1.4763967110560232,24.133046070300736,-2.505681315113774,-21.627364755186967
71,177,177,2020-02-25,1294000.0,16000.0,61641,18179,12487,5692,33915,45063,-11148,5456,9547,4091,15.488068006683864,-0.2429475468385505,6.636816404665724,2.446514483348251,8.851251602018136,9.23411365811716,-18.0853652601353
72,176,176,2020-02-26,1277000.0,-17000.0,54650,16357,16290,67,29696,36070,-6374,6307,8597,2290,15.731015553522415,-13.87163661969765,4.190301921317475,-3.8857567962675175,11.540713632204941,0.12259835315645015,-11.663311985361393
73,175,175,2020-02-27,1246000.0,-31000.0,62741,15767,16894,-1127,28401,40780,-12379,13506,18573,5067,29.602652173220054,10.722583518424953,8.076058717584992,-2.3051184260894697,21.526593455635076,-1.7962735691174831,-19.730319886517588
74,174,174,2020-02-28,1221000.0,-25000.0,69915,20401,17780,2621,36314,44877,-8563,5942,13200,7258,18.88006865479511,-1.411867215030206,10.381177143674464,2.3297153529280124,8.498891511120647,3.7488378745619686,-12.247729385682616
75,173,173,2020-03-02,1210000.0,-11000.0,71043,21535,14725,6810,35092,50598,-15506,8696,14416,5720,20.29193586982532,10.065581787367757,8.051461790746451,-1.4655799595860408,12.240474079078867,9.585743845276806,-21.826217924355674
76,172,172,2020-03-03,1232000.0,22000.0,76694,12697,17677,-4980,56154,51718,4436,544,7843,7299,10.22635408245756,0.3394629174734032,9.51704175033249,-10.822284754715037,0.7093123321250685,-6.4933371580566925,5.784024825931624
77,171,171,2020-03-04,1269000.0,37000.0,54284,18676,15040,3636,30241,28203,2038,-5674,5367,11041,9.886891164984156,0.4668371719917577,20.339326505047527,4.332893297442556,-10.452435340063369,6.698106255987032,3.75432908407634
78,170,170,2020-03-05,1298000.0,29000.0,52229,17353,14615,2738,29956,29254,702,-3440,4920,8360,9.4200539929924,0.18817516140206256,16.00643320760497,8.406962117329698,-6.586379214612571,5.24229834000268,1.3440808746098911
79,169,169,2020-03-06,1284000.0,-14000.0,41595,9471,16071,-6600,28284,22363,5921,679,3840,3161,9.231878831590336,-2.9663122812684914,7.599471090275272,-1.1814962711089168,1.6324077413150617,-15.867291741795885,14.234884000480829
80,168,168,2020-03-09,1251000.0,-33000.0,50860,17188,12349,4839,27468,34045,-6577,1738,6204,4466,12.198191112858828,3.0856923924166133,8.78096736138419,-1.0951714450443075,3.417223751474636,9.514353126228864,-12.931576877703499
81,167,167,2020-03-10,1255000.0,4000.0,48845,27707,15387,12320,16687,28634,-11947,-373,4451,4824,9.112498720442217,-14.305026824742903,9.876138806428498,2.07324589715261,-0.7636400859862832,25.222643054560344,-24.459002968574058
82,166,166,2020-03-11,1218000.0,-37000.0,45214,14134,17082,-2948,20492,24604,-4112,7060,10588,3528,23.41752554518512,3.6162329390267587,7.802892909275888,-0.8577923736077206,15.614632635909233,-6.520104392444817,-9.094528243464413
83,165,165,2020-03-12,1160000.0,-58000.0,89277,29952,23632,6320,41647,57913,-16266,9946,17678,7732,19.80129260615836,12.514766042523362,8.660685282883609,1.6346601845693538,11.140607323274754,7.079090919273722,-18.219698242548468
84,164,164,2020-03-13,1140000.0,-20000.0,119769,26987,34684,-7697,84055,76670,7385,312,8727,8415,7.286526563634998,-14.534565912314672,7.026025098314255,-0.15690702215433294,0.2605014653207424,-6.426537751838957,6.166036286518215
85,163,163,2020-03-16,1090000.0,-50000.0,66839,13378,13970,-592,38876,48068,-9192,9784,14585,4801,21.821092475949673,12.450106667562125,7.182932120468588,-1.2683221056723406,14.63816035548108,-0.885710438516435,-13.752449916964649
86,162,162,2020-03-17,1091000.0,1000.0,97311,27422,11896,15526,60770,77191,-16421,895,9119,8224,9.37098580838754,-4.868088979067034,8.451254226140929,-9.076085032446915,0.9197315822466112,15.955030777609933,-16.874762359856547
87,161,161,2020-03-18,1133000.0,42000.0,119151,52045,21310,30735,50140,76957,-26817,-3918,16966,20884,14.239074787454575,0.1906340786281185,17.527339258587848,4.671920377720655,-3.288264471133268,25.794999622327968,-22.5067351511947
88,160,160,2020-03-19,1097000.0,-36000.0,94466,46803,17678,29125,34392,64644,-30252,1127,13271,12144,14.048440708826456,-7.186998134314736,12.855418880867193,3.855117615552869,1.1930218279592657,30.831198526453967,-32.02422035441323
89,159,159,2020-03-20,1110000.0,13000.0,79664,24000,14861,9139,38747,57633,-18886,9747,16917,7170,21.2354388431412,3.2452939232632585,9.00030126531432,-3.4546176878806545,12.235137577826873,11.471932114882504,-23.70706969270938
90,158,158,2020-03-23,1066000.0,-44000.0,75697,26642,19637,7005,35437,46632,-11195,4190,13618,9428,17.990144919877935,-2.5877834997233755,12.454918953194973,-12.701627263844149,5.53522596668296,9.2539994979986,-14.78922546468156
91,157,157,2020-03-24,1144000.0,78000.0,69628,26385,17689,8696,28915,34423,-5508,-3188,14328,17516,20.57792841960131,-26.544889569120695,25.15654621703912,6.975904255574063,-4.578617797437811,12.489228471304648,-7.9106106738668345
92,156,156,2020-03-25,1120000.0,-24000.0,92747,25410,19427,5983,23632,56458,-32826,26843,43705,16862,47.12281798872201,14.794529982932945,18.18064196146506,1.5949819481984626,28.942176027256945,6.45088250832911,-35.393058535586064
93,155,155,2020-03-26,1091000.0,-29000.0,82915,21267,14052,7215,34843,55111,-20268,13053,26805,13752,32.32828800578906,6.524705623259312,16.585660013266597,-7.054077442260332,15.742627992522463,8.701682445878308,-24.44431043840077
94,154,154,2020-03-27,1109000.0,18000.0,65208,19264,13890,5374,29118,35903,-6785,1411,16826,15415,25.80358238252975,4.896530787874529,23.63973745552693,8.011140947187906,2.1638449270028217,8.241320083425348,-10.405165010428167
95,153,153,2020-03-30,1100000.0,-9000.0,51265,16130,11648,4482,24417,31605,-7188,2706,10718,8012,20.90705159465523,-5.032079001597541,15.628596508339026,-14.34559248763149,5.2784550863162005,8.742806983321955,-14.021262069638155
96,152,152,2020-03-31,1120000.0,20000.0,53853,15764,16185,-421,24120,21526,2594,-2173,13969,16142,25.93913059625277,-12.095560203143911,29.974188995970515,16.019437864748795,-4.03505839971775,-0.7817577479434757,4.816816147661227
97,151,151,2020-04-01,1071000.0,-49000.0,66300,13485,17417,-3932,27598,39631,-12033,15965,25217,9252,38.034690799396685,21.73322880074186,13.954751131221714,-37.671855120327,24.079939668174962,-5.930618401206638,-18.149321266968325
98,150,150,2020-04-02,1135000.0,64000.0,56498,19641,11061,8580,27647,16269,11378,-19958,9210,29168,16.301461998654823,-0.6229188670995143,51.62660625154872,8.822620639443045,-35.32514425289391,15.186378278877127,20.138765974016774
99,149,149,2020-04-03,1164000.0,29000.0,48374,16017,11802,4215,24170,15866,8304,-12519,8187,20706,16.924380865754333,-1.2575881699723972,42.80398561210568,-6.368806980363993,-25.87960474635135,8.713358415677844,17.166246330673502
100,148,148,2020-04-06,1223000.0,59000.0,60263,28167,6454,21713,21139,24176,-3037,-18676,10957,29633,18.18196903572673,-11.887111908762385,49.17279259246968,29.27387064901431,-30.990823556742946,36.03040007965086,-5.03957652290792
101,147,147,2020-04-07,1223000.0,0.0,60943,17138,15055,2083,25480,33761,-8281,6198,18325,12127,30.06908094448911,1.0567352654767639,19.89892194345536,-3.799294791798413,10.170159001033753,3.417947918546839,-13.588106919580591
102,146,146,2020-04-08,1211000.0,-12000.0,36450,12295,14104,-1809,13580,13708,-128,1937,10575,8638,29.012345679012352,6.444698777160398,23.69821673525377,-1.8314838571569645,5.314128943758574,-4.962962962962963,-0.3511659807956104
103,145,145,2020-04-09,1255000.0,44000.0,37474,14755,13210,1545,14262,14697,-435,-1110,8457,9567,22.56764690185195,-37.2914161282929,25.529700592410737,6.323123533817498,-2.9620536905587875,4.122858515237232,-1.1608048246784437
104,144,144,2020-04-10,1215000.0,-40000.0,38315,9983,17075,-7092,5397,13881,-8484,15576,22935,7359,59.85906303014485,25.80746744410251,19.206577058593236,1.0101857672123875,40.652485971551606,-18.509722040976122,-22.14276393057549
105,143,143,2020-04-13,1197000.0,-18000.0,26824,12846,14858,-2012,4844,7085,-2241,4253,9134,4881,34.05159558604234,17.215536086809905,18.196391291380845,0.5213079183460749,15.855204294661494,-7.500745600954369,-8.354458693707128
106,142,142,2020-04-14,1200000.0,3000.0,37782,16263,6775,9488,15158,24329,-9171,-317,6361,6678,16.83605949923244,-9.059789214493492,17.675083373034774,6.724243840220119,-0.8390238738023398,25.11248742787571,-24.273463554073373
107,141,141,2020-04-16,1191000.0,-9000.0,52827,11058,10142,916,28089,36900,-8811,7895,13680,5785,25.89584871372593,7.2308142442974175,10.950839532814658,-49.35938532383118,14.945009180911276,1.7339617998372046,-16.678970980748478
108,140,140,2020-04-17,1249000.0,58000.0,62084,16674,10916,5758,33822,13725,20097,-25855,11588,37443,18.66503446942852,1.2219567410851508,60.31022485664583,36.412684945627774,-41.64519038721732,9.274531280201018,32.3706591070163
109,139,139,2020-04-20,1262000.0,13000.0,61136,22622,13733,8889,27850,32793,-4943,-3946,10664,14610,17.443077728343365,-14.796995951558394,23.897539911018058,-15.004424886362214,-6.454462182674693,14.539714734362734,-8.08525255168804
110,138,138,2020-04-21,1299000.0,37000.0,97720,38438,17315,21123,27777,42390,-14613,-6510,31505,38015,32.24007367990176,13.39897533842492,38.90196479738027,4.194098855600629,-6.66189111747851,21.61584117887843,-14.95395006139992
111,137,137,2020-04-22,1337000.0,38000.0,72655,42346,20873,21473,16620,26565,-9945,-11528,13689,25217,18.84109834147684,5.339714795549865,34.707865941779644,-9.27607142745839,-15.8667676003028,29.55474502787145,-13.687977427568647
112,136,136,2020-04-23,1444000.0,107000.0,148170,34821,39409,-4588,93344,43590,49754,-45166,20005,65171,13.501383545926974,-0.10263708626453473,43.98393736923804,15.444061691417645,-30.482553823311058,-3.096443274616994,33.57899709792805
113,135,135,2020-04-24,1434000.0,-10000.0,75610,13715,18179,-4464,51609,35852,15757,-11293,10286,21579,13.60402063219151,-19.30813474229225,28.53987567782039,7.533066882195879,-14.935855045628884,-5.9039809549001445,20.839836000529033
114,134,134,2020-04-27,1395000.0,-39000.0,44795,10501,18506,-8005,19551,16879,2672,5333,14743,9410,32.91215537448376,7.051215910258119,21.00680879562451,6.167665043079317,11.905346578859248,-17.870298024333074,5.964951445473825
115,133,133,2020-04-28,1371000.0,-24000.0,56479,13177,13522,-345,28696,34576,-5880,6225,14606,8381,25.86093946422564,8.37644547034953,14.839143752545194,-18.910300124872304,11.021795711680449,-0.6108465093220489,-10.4109492023584
116,132,132,2020-04-29,1386000.0,15000.0,38211,10469,10187,282,21061,15128,5933,-6215,6681,12896,17.48449399387611,-1.019661130777628,33.7494438774175,17.49118689893891,-16.264949883541387,0.7380073800738007,15.526942503467588
117,131,131,2020-05-04,1362000.0,-24000.0,46930,10231,20619,-10388,28015,18681,9334,1054,8684,7630,18.50415512465374,5.405375762667897,16.258256978478588,0.8720635227395341,2.2458981461751546,-22.13509482207543,19.88919667590028
118,130,130,2020-05-06,1381000.0,19000.0,38996,10282,13343,-3061,23606,19653,3953,-892,5108,6000,13.098779361985846,2.1666569910489404,15.38619345573905,-9.929294115962673,-2.2874140937532053,-7.849523028002872,10.136937121756075
119,129,129,2020-05-07,1402000.0,21000.0,41840,8757,12591,-3834,28509,18657,9852,-6018,4574,10592,10.932122370936902,-1.0616539263983,25.31548757170173,3.127110993861609,-14.383365200764818,-9.163479923518164,23.54684512428298
120,128,128,2020-05-08,1420000.0,18000.0,45632,7093,11559,-4466,33066,23948,9118,-4652,5473,10125,11.993776297335202,3.372538147561073,22.188376577840113,-8.892618523006101,-10.19460028050491,-9.786991584852736,19.981591865357643
121,127,127,2020-05-11,1436000.0,16000.0,31434,5208,15910,-10702,23516,5754,17762,-7060,2710,9770,8.621238149774129,-5.141391666442697,31.08099510084621,16.70481655253629,-22.459756951072087,-34.04593751988293,56.50569447095501
122,126,126,2020-05-12,1419000.0,-17000.0,35531,5381,11288,-5907,25260,19135,6125,-218,4890,5108,13.762629816216824,-0.5747830012591582,14.376178548309927,-6.807529834372006,-0.6135487320931018,-16.624919084742903,17.238467816836007
123,125,125,2020-05-13,1437000.0,18000.0,30396,7526,11048,-3522,18512,12909,5603,-2081,4358,6439,14.337412817475984,4.902803742816957,21.18370838268193,-5.6215512955668,-6.846295565205947,-11.587050927753653,18.4333464929596
124,124,124,2020-05-14,1455000.0,18000.0,40839,14963,15539,-576,22023,14353,7670,-7094,3853,10947,9.434609074659027,-4.4745555644326185,26.80525967824873,-3.5340212084774123,-17.370650603589706,-1.4104165136266804,18.781067117216388
125,123,123,2020-05-15,1475000.0,20000.0,29592,8887,9109,-222,16589,11505,5084,-4862,4116,8978,13.909164639091644,-28.090897921513942,30.33928088672615,17.977305222801718,-16.430116247634494,-0.7502027575020276,17.180319005136525
126,122,122,2020-05-18,1437000.0,-38000.0,31969,6825,12285,-5460,11717,15732,-4015,9475,13427,3952,42.00006256060559,5.223072306207413,12.361975663924424,-2.8766017313419976,29.638086896681163,-17.079045325158752,-12.559041571522412
127,121,121,2020-05-19,1417000.0,-20000.0,31604,12147,12953,-806,7834,13835,-6001,6807,11623,4816,36.77699025439818,1.6003440444131058,15.238577395266425,2.145195408203893,21.53841285913176,-2.5503100873307183,-18.98810277180104
128,120,120,2020-05-20,1416000.0,-1000.0,30145,7600,8439,-839,11941,17759,-5818,6657,10604,3947,35.17664620998507,10.507366006630438,13.093381987062529,-0.11213866166739984,22.08326422292254,-2.7832144634267713,-19.300049759495767
129,119,119,2020-05-21,1412000.0,-4000.0,55863,6305,18696,-12391,35777,29790,5987,6404,13781,7377,24.669280203354635,-25.108248156768827,13.20552064872993,-8.869277924244777,11.463759554624708,-22.181050068918605,10.717290514293898
130,118,118,2020-05-22,1397000.0,-15000.0,24947,5859,12490,-6631,6670,6950,-280,6911,12418,5507,49.77752836012346,26.453094394588284,22.074798572974707,-1.2669718233360996,27.70272978714875,-26.58035034272658,-1.122379444422175
131,117,117,2020-05-25,1400000.0,3000.0,28841,10296,9246,1050,11818,12863,-1045,-5,6727,6732,23.324433965535174,6.23617038732721,23.341770396310807,-5.407654698809818,-0.017336430775631913,3.640650462882702,-3.6233140321070696
132,116,116,2020-05-26,1400000.0,0.0,23917,11721,6918,4803,8109,10123,-2014,-2789,4087,6876,17.088263578207968,-14.031478419919436,28.749425095120625,12.381564360647552,-11.661161516912653,20.08195007735084,-8.420788560438183
133,115,115,2020-05-27,1390000.0,-10000.0,28837,7212,12077,-4865,12651,12040,611,4254,8974,4720,31.1197419981274,9.000971481863601,16.36786073447307,3.565712122118552,14.751881263654331,-16.870686964663452,2.11880570100912
134,114,114,2020-05-28,1385000.0,-5000.0,33510,11274,14137,-2863,14824,15083,-259,3122,7412,4290,22.1187705162638,12.423459171788132,12.802148612354527,3.9702450477930658,9.31662190390928,-8.543718293046851,-0.7729036108624291
135,113,113,2020-05-29,1370000.0,-15000.0,54088,7478,10889,-3411,41366,38422,2944,467,5244,4777,9.69531134447567,-26.917461876329412,8.831903564561456,-7.620611726320911,0.8634077799142139,-6.306389587339151,5.442981807424936
136,112,112,2020-06-01,1363000.0,-7000.0,42182,7960,8350,-390,18778,26892,-8114,8504,15444,6940,36.61277322080507,12.42799935954643,16.452515290882367,-0.6760860289309285,20.160257929922714,-0.9245649803233608,-19.235692949599358
137,111,111,2020-06-02,1370000.0,7000.0,31065,11476,8953,2523,12076,16791,-4715,2192,7513,5321,24.18477386125865,10.213960512957804,17.128601319813296,0.09012800620986636,7.056172541445356,8.121680347658138,-15.177852889103491
138,110,110,2020-06-03,1387000.0,17000.0,48995,22152,10480,11672,19998,30167,-10169,-1503,6845,8348,13.970813348300847,-0.1425610398248427,17.03847331360343,-8.123377310113607,-3.067659965302582,23.822839065210733,-20.755179099908155
139,109,109,2020-06-04,1403000.0,16000.0,63330,24442,17812,6630,29950,29583,367,-6997,8938,15935,14.113374388125687,5.105372505329738,25.16185062371704,11.435091386249395,-11.048476235591345,10.468972051160588,0.5795041844307595
140,108,108,2020-06-05,1401000.0,-2000.0,33992,16806,7099,9707,14124,22227,-8103,-1604,3062,4666,9.008001882795952,-42.01163557943969,13.72675923746764,3.3658399452794665,-4.7187573546716886,28.55671922805366,-23.837961873381968
141,107,107,2020-06-08,1379000.0,-22000.0,37072,10343,13324,-2981,7815,19907,-12092,15073,18914,3841,51.01963746223564,16.034347358811427,10.360919292188173,-0.08765672916392475,40.65871817004748,-8.041109192921883,-32.617608977125585
142,106,106,2020-06-09,1374000.0,-5000.0,32971,7946,16543,-8597,13490,12983,507,8090,11535,3445,34.98529010342422,4.887829663978941,10.448576021352098,-3.2902020552888365,24.536714082072123,-26.074429043705074,1.5377149616329502
143,105,105,2020-06-10,1371000.0,-3000.0,28627,12926,7351,5575,7085,17343,-10258,4683,8616,3933,30.097460439445282,-22.080933306112648,13.738778076640935,-0.12405063693404728,16.358682362804345,19.474621860481363,-35.833304223285715
144,104,104,2020-06-11,1360000.0,-11000.0,56280,17029,27975,-10946,9885,20503,-10618,21564,29366,7802,52.178393745557926,8.584601933944334,13.862828713574979,-16.490395798065368,38.315565031982935,-19.44918265813788,-18.866382373845056
145,103,103,2020-06-12,1325000.0,-35000.0,37370,10806,14792,-3986,10273,11235,-962,4948,16291,11343,43.5937918116136,-3.7625252212730302,30.353224511640352,8.800256771053704,13.24056729997324,-10.666309874230668,-2.5742574257425743
146,102,102,2020-06-15,1270000.0,-55000.0,47831,8016,14344,-6328,17164,23178,-6014,12342,22651,10309,47.35631703288662,11.414982621707821,21.55296774058665,-5.628947552308234,25.803349292299966,-13.229913654324601,-12.573435637975374
147,101,101,2020-06-16,1300000.0,30000.0,34637,13602,8950,4652,8586,16272,-7686,3034,12449,9415,35.9413344111788,12.475021285952813,27.181915292894878,11.518422464161606,8.759419118283915,13.430724369893467,-22.190143488177384
148,100,100,2020-06-17,1288000.0,-12000.0,41485,8789,21289,-12500,22961,13698,9263,3237,9735,6498,23.466313125225984,5.110283000393629,15.663492828733276,5.099168058280373,7.8028202964927065,-30.1313727853441,22.328552488851393
149,99,99,2020-06-18,1274000.0,-14000.0,38772,7722,18659,-10937,23933,16017,7916,3021,7117,4096,18.356030124832355,-7.955485223551597,10.564324770452904,-2.2909618951309816,7.791705354379449,-28.208500980088722,20.416795625709273
150,98,98,2020-06-19,1287000.0,13000.0,49256,6245,14701,-8456,30051,28223,1828,6628,12960,6332,26.311515348383953,-3.785866170767747,12.855286665583884,4.177511292288063,13.456228682800065,-17.167451681013482,3.711222998213416
151,97,97,2020-06-22,1264000.0,-23000.0,46210,8750,9147,-397,23552,33053,-9501,9898,13908,4010,30.097381519151696,12.970929440135787,8.677775373295821,-38.2507566722581,21.41960614585588,-0.8591214022938758,-20.560484743562
152,96,96,2020-06-23,1321000.0,57000.0,52597,12226,13541,-1315,31363,14373,16990,-15675,9008,24683,17.126452079015912,0.9733931752178684,46.92853204555393,5.260917763088613,-29.802079966538013,-2.5001425936840502,32.302222560222056
153,95,95,2020-06-24,1345000.0,24000.0,35176,11488,10336,1152,18006,10183,7823,-8975,5682,14657,16.153058903798048,-36.22540082269545,41.66761428246532,29.24204338669877,-25.514555378667268,3.2749602001364573,22.239595178530816
154,94,94,2020-06-25,1277000.0,-68000.0,45849,10098,26884,-16786,11736,13268,-1532,18318,24015,5697,52.37845972649349,38.12340843967947,12.425570895766539,-38.004743016684706,39.952888830726955,-36.61148552858296,-3.3414033021439944
155,93,93,2020-06-26,1337000.0,60000.0,48453,8456,15638,-7182,33090,8380,24710,-17528,6907,24435,14.255051286814027,-26.172961037276238,50.43031391245124,28.858992403582892,-36.17526262563722,-14.822611602996716,50.997874228633925
156,92,92,2020-06-29,1300000.0,-37000.0,24018,9294,12512,-3218,5014,6325,-1311,4529,9710,5181,40.42801232409028,13.641710701913945,21.571321508868348,-29.246344820119013,18.856690815221924,-13.39828461986843,-5.4584061953534855
157,91,91,2020-06-30,1346000.0,46000.0,76009,31534,18506,13028,24115,18877,5238,-18266,20360,38626,26.786301622176325,-11.436934317308605,50.81766632898736,24.9428539949996,-24.031364706811036,17.140075517372946,6.891289189438092
158,90,90,2020-07-01,1326000.0,-20000.0,34636,12839,14399,-1560,8558,11275,-2717,4277,13239,8962,38.22323593948493,31.006741094124106,25.874812333987755,-39.52839235161496,12.348423605497171,-4.50398429379836,-7.84443931169881
159,89,89,2020-07-02,1379000.0,53000.0,42001,11788,6690,5098,27182,7841,19341,-24439,3031,27470,7.216494845360824,-2.3562121434350303,65.40320468560272,37.04016157243365,-58.186709840241896,12.137806242708509,46.04890359753339
160,88,88,2020-07-03,1380000.0,1000.0,41681,10180,10102,78,27511,19757,7754,-7832,3990,11822,9.572706988795854,-18.571784423897398,28.363043113169063,16.837428995104684,-18.790336124373216,0.18713562534488135,18.603200499028333
161,87,87,2020-07-06,1356000.0,-24000.0,33829,12301,6772,5529,12007,23158,-11151,5622,9521,3899,28.14449141269325,14.014528939851065,11.525614118064382,3.8226711988465287,16.618877294628867,16.343965236926902,-32.962842531555765
162,86,86,2020-07-07,1348000.0,-8000.0,50630,10006,14543,-4537,33470,32187,1283,3254,7154,3900,14.129962472842193,-33.84407465787895,7.702942919217856,-1.0070270134886783,6.4270195536243335,-8.961090262690105,2.5340707090657717
163,85,85,2020-07-08,1317000.0,-31000.0,41906,8609,11356,-2747,13193,26900,-13707,16454,20104,3650,47.97403713072114,14.862019241056108,8.709969932706532,-4.4928795036306965,39.2640671980146,-6.55514723428626,-32.70891996372834
164,84,84,2020-07-09,1307000.0,-10000.0,43377,11286,14120,-2834,17728,23530,-5802,8636,14363,5727,33.11201788966503,-9.56401804194899,13.20284943633723,-5.16139281228636,19.9091684533278,-6.5334163266247085,-13.375752126703091
165,83,83,2020-07-10,1295000.0,-12000.0,27608,5801,11968,-6167,10025,10570,-545,6712,11782,5070,42.676035931614024,14.784190934505867,18.36424224862359,-5.835680635509821,24.31179368299044,-22.337728194726168,-1.9740654882642712
166,82,82,2020-07-13,1300000.0,5000.0,20748,6892,6385,507,8069,9342,-1273,766,5787,5021,27.891844997108155,17.535421077629174,24.19992288413341,-21.239982385256766,3.6919221129747446,2.443609022556391,-6.135531135531137
167,81,81,2020-07-14,1340000.0,40000.0,42225,12221,13975,-1754,25631,9063,16568,-14814,4373,19187,10.35642391947898,1.4830154452564803,45.43990526939018,13.992921341191465,-35.08348134991119,-4.153937240970989,39.23741859088218
168,80,80,2020-07-15,1350000.0,10000.0,38328,11738,10129,1609,23189,16146,7043,-8652,3401,12053,8.8734084742225,-8.230336203241784,31.44698392819871,18.207300693688786,-22.5735754539762,4.197975370486328,18.37560008348988
169,79,79,2020-07-16,1339000.0,-11000.0,25129,10386,14601,-4215,10445,7201,3244,971,4298,3327,17.103744677464285,-7.965495025921757,13.239683234509927,-15.37641611329674,3.8640614429543554,-16.773449003143778,12.909387560189426
170,78,78,2020-07-17,1345000.0,6000.0,22386,6145,8932,-2787,10629,7048,3581,-794,5612,6406,25.06923970338604,-25.19289954890461,28.616099347806678,14.823164858120744,-3.5468596444206204,-12.449745376574645,15.996605020995267
171,77,77,2020-07-20,1321000.0,-24000.0,20409,4871,11607,-6736,5280,5987,-707,7443,10258,2815,50.26213925229066,12.07486449629164,13.792934489685926,-45.112299507569475,36.469204762604726,-33.005046793081476,-3.4641579695232494
172,76,76,2020-07-21,1385000.0,64000.0,77971,26117,13239,12878,22079,18803,3276,-16154,29775,45929,38.18727475599902,5.585693923591959,58.905233997255394,28.520523610692468,-20.717959241256363,16.5163971220069,4.2015621192494645
173,75,75,2020-07-22,1383000.0,-2000.0,32388,12458,10843,1615,9371,11704,-2333,718,10559,9841,32.60158083240706,-11.975769249035118,30.38471038656293,-16.430051132758354,2.21687044584414,4.986414721501791,-7.203285167345929
174,74,74,2020-07-23,1341000.0,-42000.0,100071,40713,33109,7604,14749,20114,-5365,-2239,44609,46848,44.57735008144218,-1.3440701400711674,46.81476151932128,7.604125708657732,-2.2374114378791057,7.598604990456777,-5.36119355257767
175,73,73,2020-07-24,1323000.0,-18000.0,50471,12485,18983,-6498,14809,11698,3111,3387,23177,19790,45.92142022151335,27.856020736977268,39.21063581066355,-12.645839704800371,6.7107844108497945,-12.874720136315904,6.163935725466108
176,72,72,2020-07-27,1346000.0,23000.0,24832,6140,5988,152,14206,5967,8239,-8391,4486,12877,18.065399484536083,0.2380193296551916,51.856475515463934,25.99833355024513,-33.79107603092783,0.6121134020618557,33.17896262886598
177,71,71,2020-07-28,1350000.0,4000.0,37319,8932,19722,-10790,21734,7947,13787,-2997,6653,9650,17.827380154880892,10.163367076481574,25.85814196521879,-28.658881277371307,-8.030761810337898,-28.91288619737935,36.94364800771725
178,70,70,2020-07-29,1390000.0,40000.0,56276,11628,16604,-4976,40335,8992,31343,-26367,4313,30680,7.664013078399317,-5.210652901446792,54.51702324259009,20.274725827825602,-46.85301016419077,-8.842135190845118,55.6951453550359
179,69,69,2020-07-30,1385000.0,-5000.0,31061,10349,12632,-2283,16713,7793,8920,-6637,3999,10636,12.874665979846108,-5.6767670350394726,34.242297414764494,22.51157090954343,-21.367631434918387,-7.3500531212774876,28.717684556195874
180,68,68,2020-07-31,1371000.0,-14000.0,27006,8840,11449,-2609,13156,12389,767,1842,5010,3168,18.551433014885585,-8.782050502423122,11.730726505221062,3.8911229909160383,6.820706509664519,-9.660816114937422,2.8401096052729025
181,67,67,2020-08-03,1350000.0,-21000.0,39951,8459,16397,-7938,20572,20422,150,7788,10920,3132,27.333483517308704,5.317324868759312,7.839603514305023,-8.594476544453697,19.49388000300368,-19.869339941428247,0.3754599384245701
182,66,66,2020-08-04,1354000.0,4000.0,27230,10205,11003,-798,11030,11752,-722,1520,5995,4475,22.0161586485494,0.6365108990386297,16.43408005875872,-9.38732276336508,5.582078589790672,-2.930591259640103,-2.6514873301505686
183,65,65,2020-08-05,1364000.0,10000.0,38836,9799,13154,-3355,20734,15654,5080,-1725,8303,10028,21.379647749510767,13.143079777289572,25.8214028221238,-3.8541376326422783,-4.441755072613041,-8.638891749922752,13.080646822535794
184,64,64,2020-08-06,1385000.0,21000.0,26783,12914,11942,972,11663,6893,4770,-5742,2206,7948,8.236567972221186,-3.5953770633476108,29.67554045476608,-18.760344509057113,-21.438972482544894,3.629167755665907,17.809804726878987
185,63,63,2020-08-07,1432000.0,47000.0,65788,15497,19825,-4328,42507,14098,28409,-24081,7784,31865,11.831945035568795,-1.83674581185174,48.435884963823185,17.203323007479845,-36.60393992825439,-6.578707363044933,43.182647291299325
186,62,62,2020-08-10,1445000.0,13000.0,36558,11829,17935,-6106,19732,7205,12527,-6421,4997,11418,13.668690847420535,-8.140344676862973,31.232561956343346,-12.896063408338303,-17.563871108922807,-16.702226598829256,34.26609770775207
187,61,61,2020-08-11,1573000.0,128000.0,93232,26105,33724,-7619,46794,18366,28428,-20809,20333,41142,21.809035524283512,-3.3046625964796235,44.128625364681646,23.591455375264875,-22.319589840398148,-8.172086837137464,30.49167667753561
188,60,60,2020-08-12,1548000.0,-25000.0,34961,13889,15951,-2062,12292,11830,462,1600,8780,7180,25.11369812076313,6.734851133333571,20.537169989416785,1.6815132924076757,4.5765281313463575,-5.898000629272617,1.3214724979262606
189,59,59,2020-08-13,1560000.0,12000.0,43833,19252,17069,2183,16525,18499,-1974,-209,8056,8265,18.378846987429558,-8.244802357765355,18.855656697009106,-4.480603850507219,-0.4768097095795406,4.980266009627449,-4.503456300047909
190,58,58,2020-08-14,1565000.0,5000.0,26191,14420,11551,2869,4798,8528,-3730,861,6973,6112,26.62364934519492,2.4435646832492743,23.33626054751632,9.776502664856196,3.2873887976785916,10.954144553472569,-14.241533351151158
191,57,57,2020-08-18,1500000.0,-65000.0,50554,16926,13679,3247,21404,30020,-8616,5369,12224,6855,24.18008466194564,12.288906954901021,13.559757882660124,-12.009277010139105,10.620326779285515,6.4228349883293125,-17.043161767614826
192,56,56,2020-08-19,1519000.0,19000.0,33302,13088,14695,-1607,16254,10092,6162,-4555,3960,8515,11.891177707044616,-0.4192057624937391,25.56903489279923,12.496085484539465,-13.67785718575461,-4.825536003843613,18.50339318959822
193,55,55,2020-08-20,1500000.0,-19000.0,36587,17786,26127,-8341,14297,5677,8620,-279,4504,4783,12.31038346953836,-4.151787001392348,13.072949408259769,-30.4616154365317,-0.7625659387214038,-22.79771503539509,23.560280974116488
194,54,54,2020-08-21,1563000.0,63000.0,36757,13996,11071,2925,16710,9684,7026,-9951,6051,16002,16.462170470930708,-17.386733617364026,43.53456484479147,30.22040348928082,-27.07239437386076,7.957667927197541,19.11472644666322
195,53,53,2020-08-24,1543000.0,-20000.0,25732,7608,10711,-3103,9414,11595,-2181,5284,8710,3426,33.84890408829473,5.578883039883382,13.314161355510647,2.193584027656584,20.53474273278408,-12.058914969687548,-8.475827763096534
196,52,52,2020-08-25,1539000.0,-4000.0,19954,7912,12531,-4619,6401,5204,1197,3422,5641,2219,28.27002104841135,-7.97844259912576,11.120577327854063,0.5386542872943583,17.149443720557283,-23.14824095419465,5.998797233637366
197,51,51,2020-08-26,1517000.0,-22000.0,42308,6335,16794,-10459,20637,21037,-400,10859,15336,4477,36.24846364753711,-12.043730541368987,10.581923040559706,-13.518632565597501,25.666540606977406,-24.721092937505908,-0.9454476694714948
198,50,50,2020-08-27,1499000.0,-18000.0,21958,6721,12478,-5757,4633,4188,445,5312,10604,5292,48.292194188906095,35.374582409274396,24.10055560615721,6.031277223934302,24.191638582748887,-26.218234811913646,2.026596229164769
199,49,49,2020-08-28,1509000.0,10000.0,26011,9663,9977,-314,12988,11334,1654,-1340,3360,4700,12.917611779631693,-14.123963594330275,18.069278382222905,7.352191092872367,-5.151666602591211,-1.2071815770251049,6.3588481796163165
200,48,48,2020-08-31,1473000.0,-36000.0,36969,16500,14986,1514,10472,18021,-7549,6035,9997,3962,27.04157537396197,15.114506083047974,10.717087289350538,-16.999278307845472,16.32448808461143,4.0953231085504065,-20.41981119316184
201,47,47,2020-09-01,1513000.0,40000.0,29672,11021,10061,960,15112,11387,3725,-4685,3539,8224,11.927069290913993,-24.010306217013664,27.716365597196013,16.745128245590557,-15.789296306282015,3.2353734160150984,12.55392289026692
202,46,46,2020-09-02,1499000.0,-14000.0,25102,7718,6352,1366,8363,15996,-7633,6267,9021,2754,35.93737550792765,-5.08591619289696,10.971237351605446,-3.4667237806701934,24.966138156322213,5.441797466337343,-30.40793562265955
203,45,45,2020-09-03,1483000.0,-16000.0,20737,6096,10088,-3992,6134,7655,-1521,5513,8507,2994,41.02329170082462,-3.4936592951046634,14.437961132275642,1.1785844814568378,26.58533056854897,-19.250614843034192,-7.33471572551478
204,44,44,2020-09-04,1453000.0,-30000.0,32181,4219,11928,-7709,13636,15986,-2350,10059,14326,4267,44.51695099592928,22.603674286049966,13.259376650818806,-14.76923309437565,31.25757434511047,-23.955128802709673,-7.302445542400797
205,43,43,2020-09-07,1475000.0,22000.0,22370,4008,6300,-2292,13460,9800,3660,-1368,4902,6270,21.9132767098793,9.043657522930687,28.028609745194448,-3.5004056380568653,-6.115333035315154,-10.245864997764862,16.36119803308002
206,42,42,2020-09-08,1493000.0,18000.0,22557,7574,10120,-2546,12080,5325,6755,-4209,2903,7112,12.869619186948619,5.587046526986192,31.52901538325132,4.852034501385923,-18.6593961963027,-11.286961918694864,29.946358114997558
207,41,41,2020-09-09,1510000.0,17000.0,36196,12579,11036,1543,20981,15504,5477,-7020,2636,9656,7.282572659962428,-2.0282841834300083,26.676980881865397,-7.963599081450178,-19.394408221902967,4.262901978119129,15.131506243783846
208,40,40,2020-09-10,1527000.0,17000.0,34347,10698,17392,-6694,20451,5057,15394,-8700,3198,11898,9.310856843392436,-1.6388808191427326,34.64057996331557,20.09415763801712,-25.329723119923138,-19.48932949020293,44.819052610126064
209,39,39,2020-09-11,1518000.0,-9000.0,26302,6957,9215,-2258,16465,13261,3204,-946,2880,3826,10.949737662535169,-4.4852532862455785,14.546422325298455,1.6244757807345105,-3.596684662763288,-8.584898486807086,12.181583149570374
210,38,38,2020-09-14,1519000.0,1000.0,18782,6879,9320,-2441,9004,7035,1969,472,2899,2427,15.434990948780749,-4.709277060514371,12.921946544563944,-13.506209923290431,2.5130444042168034,-12.996485997231392,10.483441593014588
211,37,37,2020-09-15,1533000.0,14000.0,20656,5293,7220,-1927,11202,7977,3225,-1298,4161,5459,20.14426800929512,-26.475979695430993,26.42815646785437,13.39593020622396,-6.2838884585592565,-9.329008520526726,15.61289697908598
212,36,36,2020-09-16,1506000.0,-27000.0,16229,5114,6745,-1631,3549,7369,-3820,5451,7566,2115,46.620247704726104,12.214705872484672,13.032226261630411,-2.712591695624443,33.58802144309569,-10.049910653767947,-23.538110789327746
213,35,35,2020-09-17,1508000.0,2000.0,18622,6609,10190,-3581,5606,5500,106,3475,6407,2932,34.40554183224144,27.75734238625806,15.744817957254858,-4.0796321979365455,18.660723874986573,-19.229943078079692,0.5692192030931157
214,34,34,2020-09-18,1516000.0,8000.0,29963,7902,8527,-625,20069,15496,4573,-3948,1992,5940,6.64819944598338,-16.151945202039762,19.824450155191407,5.359647840823035,-13.176250709208025,-2.085905950672496,15.26215665988052
215,33,33,2020-09-21,1497000.0,-19000.0,16592,9198,5174,4024,3611,9018,-5407,1383,3783,2400,22.800144648023142,-13.046246877026519,14.464802314368367,-1.355104990862264,8.335342333654774,24.252651880424303,-32.587994214079075
216,32,32,2020-09-22,1473000.0,-24000.0,22655,5642,11099,-5457,8892,7972,920,4537,8121,3584,35.84639152504966,3.576887978950367,15.819907305230632,3.9091855697279208,20.026484219819025,-24.08739792540278,4.060913705583757
217,31,31,2020-09-23,1455000.0,-18000.0,23970,8721,10526,-1805,7514,10589,-3075,4880,7735,2855,32.269503546099294,-4.674642319580073,11.910721735502715,-4.116986373896548,20.35878181059658,-7.530246141009594,-12.828535669586985
218,30,30,2020-09-24,1418000.0,-37000.0,25119,7670,7837,-167,8169,13256,-5087,5254,9280,4026,36.94414586567937,14.31616631584868,16.02770810939926,1.5399582919900592,20.91643775628011,-0.6648353835741869,-20.25160237270592
219,29,29,2020-09-25,1419000.0,1000.0,15061,7696,6678,1018,3957,6201,-2244,1226,3408,2182,22.62797954983069,12.565563143232383,14.487749817409199,-12.685678626638945,8.140229732421487,6.759179337361398,-14.899409069782884
220,28,28,2020-09-28,1469000.0,50000.0,22430,8082,5395,2687,12091,10940,1151,-3838,2257,6095,10.062416406598308,-6.7366755343778575,27.17342844404815,16.97496251345963,-17.111012037449846,11.979491752117697,5.131520285332145
221,27,27,2020-09-29,1448000.0,-21000.0,29073,9615,6941,2674,14574,19167,-4593,1919,4884,2965,16.799091940976158,9.247197909799358,10.198465930588519,-32.10021753601353,6.600626010387645,9.197537233859597,-15.798163244247242
222,26,26,2020-10-05,1499000.0,51000.0,37143,18353,8662,9691,15985,12770,3215,-12906,2805,15711,7.551894031176803,-5.352911934098329,42.29868346660205,26.340483934680208,-34.74678943542525,26.091053495948092,8.655735939477156
223,25,25,2020-10-06,1500000.0,1000.0,18373,6165,8533,-2368,9837,6908,2929,-561,2371,2932,12.904805965275132,5.76194882241799,15.95819953192184,-12.367464555089247,-3.0533935666467102,-12.888477657432102,15.941871224078813
224,24,24,2020-10-07,1513000.0,13000.0,19124,10789,5331,5458,6969,8376,-1407,-4051,1366,5417,7.142857142857142,3.0469105814483064,28.325664087011088,-1.3782982630724092,-21.182806944153945,28.540054381928467,-7.357247437774523
225,23,23,2020-10-08,1540000.0,27000.0,32935,13284,14335,-1051,18302,8817,9485,-8434,1349,9783,4.095946561408836,-9.26086470800048,29.70396235008349,-21.18766563134759,-25.608015788674663,-3.1911340519204487,28.799149840595106
226,22,22,2020-10-12,1585000.0,45000.0,31235,17480,8749,8731,9583,6590,2993,-11724,4172,15896,13.356811269409315,-11.007169324603224,50.89162798143109,36.26613987351486,-37.53481671202177,27.952617256283016,9.582199455738754
227,21,21,2020-10-13,1548000.0,-37000.0,25353,8087,10177,-2090,11089,11468,-379,2469,6177,3708,24.363980594012546,13.077145741351952,14.625488107916224,4.932886878321144,9.73849248609632,-8.243600362876187,-1.4948921232201318
228,20,20,2020-10-14,1546000.0,-2000.0,23585,6144,6531,-387,14779,14768,11,376,2662,2286,11.28683485266059,2.888032009413301,9.69260122959508,-6.558801688474502,1.5942336230655076,-1.640873436506254,0.04663981344074624
229,19,19,2020-10-15,1569000.0,23000.0,26730,6323,7673,-1350,18162,14713,3449,-2099,2245,4344,8.39880284324729,1.7190763317623068,16.251402918069587,-4.010562204462492,-7.852600074822298,-5.05050505050505,12.903105125327349
230,18,18,2020-10-16,1571000.0,2000.0,26034,12412,9545,2867,11883,11214,669,-3536,1739,5275,6.679726511484983,-2.021664492677877,20.261965122532075,11.682413899057613,-13.582238611047092,11.012522086502264,2.5697165245448264
231,17,17,2020-10-19,1562000.0,-9000.0,29547,15929,13672,2257,11047,13340,-2293,36,2571,2535,8.70139100416286,-4.268606243291037,8.579551223474464,-8.28254621665766,0.12183978068839475,7.638677361491862,-7.760517142180254
232,16,16,2020-10-20,1547000.0,-15000.0,18165,6876,6403,473,8933,8699,234,-707,2356,3063,12.969997247453895,-1.3324761126008493,16.862097440132125,8.20044918517074,-3.8921001926782273,2.603908615469309,1.2881915772089183
233,15,15,2020-10-21,1551000.0,4000.0,20458,11075,10550,525,6457,8136,-1679,1154,2926,1772,14.302473360054742,-15.069515728110554,8.661648254961385,-3.9246887349974067,5.640825105093362,2.5662332583830287,-8.20705836347639
234,14,14,2020-10-22,1539000.0,-12000.0,34458,11004,17079,-6075,13333,13042,291,5784,10121,4337,29.371989088165307,13.180240794903204,12.586336989958793,-0.3848710836535556,16.785652098206512,-17.630158453769806,0.8445063555632945
235,13,13,2020-10-23,1539000.0,0.0,26952,8808,12602,-3794,13780,10854,2926,868,4364,3496,16.191748293262094,-14.998921628083167,12.971208073612347,2.865431019096482,3.2205402196497483,-14.076877411694865,10.856337192045116
236,12,12,2020-10-26,1515000.0,-24000.0,18435,5589,8699,-3110,7096,7873,-777,3887,5750,1863,31.19066992134527,24.68988222789702,10.105777054515864,-3.65337408995638,21.0848928668294,-16.87008407919718,-4.214808787632221
237,11,11,2020-10-27,1543000.0,28000.0,43164,5213,10121,-4908,35145,27104,8041,-3133,2806,5939,6.5007876934482445,-19.863328401538556,13.759151144472243,2.281578585105491,-7.2583634510240005,-11.370586599944398,18.6289500509684
238,10,10,2020-10-28,1524000.0,-19000.0,18950,3670,8713,-5043,10284,8062,2222,2821,4996,2175,26.364116094986805,-12.619006625732393,11.477572559366756,-1.42209667988352,14.886543535620053,-26.61213720316623,11.725593667546176
239,9,9,2020-10-29,1507000.0,-17000.0,23582,4516,12108,-7592,9873,8432,1441,6151,9193,3042,38.9831227207192,11.282981488280331,12.899669239250276,5.280550827000218,26.083453481468922,-32.19404630650496,6.110592825036044
240,8,8,2020-10-30,1500000.0,-7000.0,26906,2956,8644,-5688,16497,16212,285,5403,7453,2050,27.700141232438863,15.938485888353398,7.6191184122500575,-42.0204604914475,20.08102282018881,-21.14026611164796,1.059243291459154
