날짜,종가,대비,거래량,기관 매수,기관 매도,기관 순매수,외국인 매수,외국인 매도,외국인 순매수,개인 순매수
2020-11-11,86800,900,960361,227702,230372,-2670,326591,353667,-27076,29746
2020-11-10,85900,-1400,898189,98093,520892,-422799,167241,117701,49540,373259
2020-11-09,87300,200,586050,134698,230406,-95708,107707,101321,6386,89322
2020-11-06,87100,600,707090,137305,222207,-84902,223806,90793,133013,-48111
2020-11-05,86500,400,754241,121867,423509,-301642,94960,106327,-11367,313009
2020-11-04,86100,-200,602908,172933,290730,-117797,126020,125867,153,117644
2020-11-03,86300,800,409909,156615,132446,24169,63791,52395,11396,-35565
2020-11-02,85500,1500,510392,155044,171043,-15999,126171,34417,91754,-75755
2020-10-30,84000,-3200,981485,97529,297793,-200264,197937,194765,3172,197092
2020-10-29,87200,-2800,786668,88682,266910,-178228,67833,276150,-208317,386545
2020-10-28,90000,600,375683,84419,136598,-52179,189494,85681,103813,-51634
2020-10-27,89400,300,523862,120429,213295,-92866,239962,106470,133492,-40626
2020-10-26,89100,-500,397433,58782,176104,-117322,192994,54283,138711,-21389
2020-10-23,89600,1200,453141,81570,104443,-22873,243517,80136,163381,-140508
2020-10-22,88400,-2000,598631,61032,163954,-102922,90287,162995,-72708,175630
2020-10-21,90400,-300,502901,95328,234823,-139495,208219,109819,98400,41095
2020-10-20,90700,1600,498432,155571,109207,46364,132363,56622,75741,-122105
2020-10-19,89100,-800,487840,131845,176204,-44359,102685,106597,-3912,48271
2020-10-16,89900,-1500,749853,105345,204723,-99378,126294,94888,31406,67972
2020-10-15,91400,0,678538,138792,221875,-83083,237421,98953,138468,-55385
2020-10-14,91400,-300,847948,145916,286077,-140161,233661,209185,24476,115685
2020-10-13,91700,-200,1015570,183145,332429,-149284,222436,108736,113700,35584
2020-10-12,91900,-1400,1139080,91128,370907,-279779,183841,257672,-73831,353610
2020-10-08,93300,-2800,2181852,362224,793552,-431328,355135,347626,7509,423819
2020-10-07,96100,1700,1263545,315330,264567,50763,464674,302556,162118,-212881
2020-10-06,94400,2300,2733167,517620,599783,-82163,703876,269804,434072,-351909
2020-10-05,92100,400,1007727,186363,302059,-115696,452195,307831,144364,-28668
2020-09-29,91700,0,808542,158547,136412,22135,292357,253973,38384,-60519
2020-09-28,91700,-1200,905918,195510,285272,-89762,188274,191387,-3113,92875
2020-09-25,92900,3400,1625943,554999,280100,274899,376890,189412,187478,-462377
2020-09-24,89500,-1700,1150871,461461,310539,150922,225442,341006,-115564,-35358
2020-09-23,91200,2300,1121711,380964,325952,55012,377624,209150,168474,-223486
2020-09-22,88900,-2000,1054942,156623,366137,-209514,337702,311847,25855,183659
2020-09-21,90900,1000,1050515,279686,389868,-110182,221416,110478,110938,-756
2020-09-18,89900,-700,931059,204413,329501,-125088,276960,289058,-12098,137186
2020-09-17,90600,0,870174,279886,239928,39958,107211,147625,-40414,456
2020-09-16,90600,-1200,815205,164829,236297,-71468,147109,143277,3832,67636
2020-09-15,91800,-300,952767,190231,296051,-105820,336880,172930,163950,-58130
2020-09-14,92100,-300,1226790,280507,371640,-91133,178587,236545,-57958,149091
2020-09-11,92400,-800,1507008,462990,320410,142580,99524,425104,-325580,183000
2020-09-10,93200,3000,2880767,916985,564324,352661,403330,362947,40383,-393044
2020-09-09,90200,4400,3555936,1166580,578593,587987,748053,258353,489700,-1077687
2020-09-08,85800,2000,1367597,474367,246490,227877,147388,209678,-62290,-165587
2020-09-07,83800,-200,629528,106680,225949,-119269,102542,61742,40800,78469
2020-09-04,84000,-1700,974597,91798,418464,-326666,207288,92366,114922,211744
2020-09-03,85700,-800,764553,135125,273276,-138151,117053,106569,10484,127667
2020-09-02,86500,-1200,1170481,205079,355396,-150317,89209,312496,-223287,373604
2020-09-01,87700,3500,1133236,455949,222247,233702,129058,201957,-72899,-160803
2020-08-31,84200,-1700,1388783,379875,262841,117034,349285,671244,-321959,204925
2020-08-28,85900,-300,954228,233627,344481,-110854,142115,127004,15111,95743
2020-08-27,86200,-1700,1330067,207589,553814,-346225,356998,71547,285451,60774
2020-08-26,87900,-2400,1571474,248481,669513,-421032,261943,265326,-3383,424415
2020-08-25,90300,-300,1161120,411053,399800,11253,147100,143489,3611,-14864
2020-08-24,90600,300,1265081,596727,370404,226323,111555,208042,-96487,-129836
2020-08-21,90300,5400,2978055,1033499,565093,468406,472936,149379,323557,-791963
2020-08-20,84900,-100,1424255,656533,515443,141090,161773,88594,73179,-214269
2020-08-19,85000,1000,1316003,388994,384861,4133,333362,123011,210351,-214484
2020-08-18,84000,-4700,1462971,419995,423322,-3327,252832,188799,64033,-60706
2020-08-14,88700,1700,1669303,584232,504675,79557,178582,94914,83668,-163225
2020-08-13,87000,-300,1950559,617840,606589,11251,234650,178761,55889,-67140
2020-08-12,87300,4300,2704977,750319,557570,192749,558954,266103,292851,-485600
2020-08-11,83000,-2700,1684857,411404,515471,-104067,169138,281422,-112284,216351
2020-08-10,85700,8500,3706582,1317890,716245,601645,540136,202952,337184,-938829
2020-08-07,77200,0,759800,214036,321842,-107806,184903,90916,93987,13819
2020-08-06,77200,-1100,899941,336229,237715,98514,95407,111530,-16123,-82391
2020-08-05,78300,400,1197933,310822,303564,7258,361384,142881,218503,-225761
2020-08-04,77900,3900,1738014,580155,326724,253431,430969,125311,305658,-559089
2020-08-03,74000,3300,1183563,299974,237338,62636,426263,177106,249157,-311793
2020-07-31,70700,-1400,851076,152525,362507,-209982,158604,180359,-21755,231737
2020-07-30,72100,100,735701,155457,218384,-62927,132004,221353,-89349,152276
2020-07-29,72000,-500,804210,146302,281040,-134738,224524,134004,90520,44218
2020-07-28,72500,-1100,975596,149805,372746,-222941,243555,157637,85918,137023
2020-07-27,73600,-500,568984,131813,113423,18390,129167,138617,-9450,-8940
2020-07-24,74100,0,698830,194875,254300,-59425,251459,94318,157141,-97716
2020-07-23,74100,-900,759138,106726,205993,-99267,266199,101217,164982,-65715
2020-07-22,75000,100,801570,110716,257631,-146915,374287,120434,253853,-106938
2020-07-21,74900,-1100,912127,145842,268554,-122712,357043,194168,162875,-40163
2020-07-20,76000,300,901831,190190,274213,-84023,329267,105845,223422,-139399
2020-07-17,75700,1200,1266762,374644,244004,130640,288612,210248,78364,-209004
2020-07-16,74500,-400,1184023,296244,258167,38077,276786,153160,123626,-161703
2020-07-15,74900,4100,2504840,582992,366488,216504,900741,172572,728169,-944673
2020-07-14,70800,2300,1780194,482750,322490,160260,452429,144105,308324,-468584
2020-07-13,68500,300,569857,168407,132770,35637,140478,58327,82151,-117788
2020-07-10,68200,500,781290,290381,249536,40845,264155,109768,154387,-195232
2020-07-09,67700,1300,984866,286320,277139,9181,421459,225153,196306,-205487
2020-07-08,66400,900,1111546,436000,363358,72642,212256,161686,50570,-123212
2020-07-07,65500,-2600,1720050,567138,586353,-19215,331799,253810,77989,-58774
2020-07-06,68100,3100,1461414,611340,238308,373032,237800,95543,142257,-515289
2020-07-03,65000,400,494161,142245,144100,-1855,44337,169598,-125261,127116
2020-07-02,64600,200,451291,111986,163201,-51215,179013,165843,13170,38045
2020-07-01,64400,1200,564319,272725,134885,137840,56349,125836,-69487,-68353
2020-06-30,63200,-300,648411,151363,198861,-47498,214875,266412,-51537,99035
2020-06-29,63500,-1200,756841,210571,190431,20140,195287,159299,35988,-56128
2020-06-26,64700,0,528872,102782,162347,-59565,129046,104277,24769,34796
2020-06-25,64700,-2300,798688,175257,301425,-126168,87281,129010,-41729,167897
2020-06-24,67000,400,622511,177964,123704,54260,122042,168565,-46523,-7737
2020-06-23,66600,-900,849668,304053,277214,26839,107329,141477,-34148,7309
2020-06-22,67500,-1300,632910,152446,173618,-21172,139311,146864,-7553,28725
2020-06-19,68800,1000,861053,284388,205411,78977,230590,181594,48996,-127973
2020-06-18,67800,-400,946224,274810,187485,87325,189667,198525,-8858,-78467
2020-06-17,68200,3000,1576915,777523,318976,458547,232277,200865,31412,-489959
2020-06-16,65200,2300,1220699,242507,260828,-18321,184036,291765,-107729,126050
2020-06-15,62900,-4900,1545344,452323,239054,213269,218413,324492,-106079,-107190
2020-06-12,67800,-1200,1689624,386297,229318,156979,189086,238651,-49565,-107414
2020-06-11,69000,-1100,1942350,520292,433958,86334,258801,535839,-277038,190704
2020-06-10,70100,3500,2744224,871272,468775,402497,500458,361524,138934,-541431
2020-06-09,66600,2600,1897513,567783,310078,257705,304159,230371,73788,-331493
2020-06-08,64000,1000,975466,411833,232788,179045,126471,118218,8253,-187298
2020-06-05,63000,800,860924,326686,253410,73276,186187,109559,76628,-149904
2020-06-04,62200,100,934862,335568,234483,101085,110480,94470,16010,-117095
2020-06-03,62100,2100,1433963,559624,244346,315278,270304,121932,148372,-463650
2020-06-02,60000,800,846026,249232,161971,87261,195073,111292,83781,-171042
2020-06-01,59200,-100,550906,126106,185661,-59555,33684,86934,-53250,112805
2020-05-29,59300,800,900113,250533,268911,-18378,423094,277736,145358,-126980
2020-05-28,58500,-1000,1094166,305470,329818,-24348,95710,229929,-134219,158567
2020-05-27,59500,2400,1707086,415606,298201,117405,487636,85018,402618,-520023
2020-05-26,57100,1000,674912,224312,105862,118450,132963,103073,29890,-148340
2020-05-25,56100,-200,478311,132837,129332,3505,10284,83306,-73022,69517
2020-05-22,56300,-900,518452,126720,119162,7558,121303,92720,28583,-36141
2020-05-21,57200,-800,709139,115273,201200,-85927,73273,194121,-120848,206775
2020-05-20,58000,-200,552137,110719,156740,-46021,124692,129471,-4779,50800
2020-05-19,58200,1800,1138915,301291,138651,162640,255196,161941,93255,-255895
2020-05-18,56400,2000,1005066,275529,169438,106091,323622,107557,216065,-322156
2020-05-15,54400,200,504474,160310,164834,-4524,128568,119499,9069,-4545
2020-05-14,54200,-800,593689,175079,220703,-45624,156154,180238,-24084,69708
2020-05-13,55000,500,577061,212760,186766,25994,171039,159245,11794,-37788
2020-05-12,54500,0,707739,147070,168771,-21701,294969,190038,104931,-83230
2020-05-11,54500,-700,536547,80544,164182,-83638,123794,103013,20781,62857
2020-05-08,55200,500,632501,129354,185402,-56048,218950,147800,71150,-15102
2020-05-07,54700,-800,754248,141984,106194,35790,135902,310306,-174404,138614
2020-05-06,55500,300,805783,145409,83982,61427,287831,400777,-112946,51519
2020-05-04,55200,300,1119161,114292,295456,-181164,535968,224007,311961,-130797
2020-04-29,54900,1300,1017067,162346,142560,19786,270687,128343,142344,-162130
2020-04-28,53600,200,712240,125673,192122,-66449,142412,125759,16653,49796
2020-04-27,53400,800,561740,179935,111225,68710,146562,111570,34992,-103702
2020-04-24,52600,-700,529035,153272,216876,-63604,89475,105354,-15879,79483
2020-04-23,53300,900,702412,217407,203936,13471,166690,92662,74028,-87499
2020-04-22,52400,-200,727548,136795,343448,-206653,140414,120674,19740,186913
2020-04-21,52600,-1200,1029388,218896,347540,-128644,140274,122827,17447,111197
2020-04-20,53800,-700,809110,154032,239039,-85007,58123,189314,-131191,216198
2020-04-17,54500,1000,1414373,174510,186876,-12366,180236,189497,-9261,21627
2020-04-16,53500,-100,788724,115346,125795,-10449,192677,345007,-152330,162779
2020-04-14,53600,400,922591,382932,167198,215734,140033,441077,-301044,85310
2020-04-13,53200,-600,626957,134576,211324,-76748,47571,70767,-23196,99944
2020-04-10,53800,-400,687486,131514,198745,-67231,31128,96653,-65525,132756
2020-04-09,54200,900,926771,282828,228351,54477,90515,226124,-135609,81132
2020-04-08,53300,-1200,1593974,306600,443070,-136470,222219,478900,-256681,393151
2020-04-07,54500,3400,2123508,541826,428578,113248,139706,357166,-217460,104212
2020-04-06,51100,1250,868309,237935,121800,116135,144539,175061,-30522,-85613
2020-04-03,49850,550,963015,229583,202211,27372,188130,315521,-127391,100019
2020-04-02,49300,1200,1071663,427787,238928,188859,239865,390118,-150253,-38606
2020-04-01,48100,-100,1298461,416014,361389,54625,349134,303791,45343,-99968
2020-03-31,48200,-300,1106424,244399,304299,-59900,296877,466623,-169746,229646
2020-03-30,48500,-900,937027,291545,275508,16037,205829,415198,-209369,193332
2020-03-27,49400,400,1110394,391458,327057,64401,110848,331532,-220684,156283
2020-03-26,49000,500,1377158,353788,314926,38862,257323,345680,-88357,49495
2020-03-25,48500,4100,1506779,463722,418931,44791,281435,268524,12911,-57702
2020-03-24,44400,2550,1316623,395941,283847,112094,256173,394521,-138348,26254
2020-03-23,41850,-3250,1186795,312824,409634,-96810,205624,363855,-158231,255041
2020-03-20,45100,1450,1539670,409615,325414,84201,313351,622114,-308763,224562
2020-03-19,43650,-4350,1601945,472296,437694,34602,429478,512663,-83185,48583
2020-03-18,48000,-1450,886739,260658,249835,10823,184108,302526,-118418,107595
2020-03-17,49450,-950,1004008,271292,269882,1410,316979,352971,-35992,34582
2020-03-16,50400,-2100,948845,194928,304573,-109645,220487,314025,-93538,203183
2020-03-13,52500,-3000,1968749,527532,706966,-179434,747875,715968,31907,147527
2020-03-12,55500,-3500,1649095,596438,390037,206401,330547,881378,-550831,344430
2020-03-11,59000,-1000,938290,255388,252225,3163,296739,482524,-185785,182622
2020-03-10,60000,2200,1500440,529333,448895,80438,605679,438526,167153,-247591
2020-03-09,57800,-2500,1001568,351097,219172,131925,150001,473920,-323919,191994
2020-03-06,60300,-1200,542438,196326,222065,-25739,105768,199777,-94009,119748
2020-03-05,61500,900,573595,179508,218224,-38716,147371,161011,-13640,52356
2020-03-04,60600,400,520867,128206,164929,-36723,179817,192382,-12565,49288
2020-03-03,60200,100,587763,129526,261323,-131797,80161,149195,-69034,200831
2020-03-02,60100,-300,711979,240773,260950,-20177,115743,251075,-135332,155509
2020-02-28,60400,-2000,932828,407022,239339,167683,166864,308650,-141786,-25897
2020-02-27,62400,-900,524379,284116,226854,57262,52524,162641,-110117,52855
2020-02-26,63300,300,607215,245306,227691,17615,207478,148846,58632,-76247
2020-02-25,63000,-300,956415,266771,226673,40098,250567,542797,-292230,252132
2020-02-24,63300,-2800,874557,383200,223592,159608,76821,307981,-231160,71552
2020-02-21,66100,-1100,531902,206238,223102,-16864,95700,137342,-41642,58506
2020-02-20,67200,-1600,677402,165255,297390,-132135,139854,164779,-24925,157060
2020-02-19,68800,-100,636116,213219,156117,57102,214451,247097,-32646,-24456
2020-02-18,68900,1900,1338368,541154,342634,198520,272517,212054,60463,-258983
2020-02-17,67000,0,560384,246934,157311,89623,65681,171357,-105676,16053
2020-02-14,67000,-100,354348,119883,183597,-63714,98393,57987,40406,23308
2020-02-13,67100,-800,699540,190023,376816,-186793,255836,152130,103706,83087
2020-02-12,67900,700,487071,195878,169460,26418,149672,99337,50335,-76753
2020-02-11,67200,200,462160,156695,162153,-5458,171597,125657,45940,-40482
2020-02-10,67000,-300,364246,149877,126366,23511,73404,126509,-53105,29594
2020-02-07,67300,500,519466,165621,215925,-50304,220767,58631,162136,-111832
2020-02-06,66800,1600,635295,192943,237950,-45007,207755,140284,67471,-22464
2020-02-05,65200,100,657342,186462,272911,-86449,225149,211308,13841,72608
2020-02-04,65100,200,716163,187115,344819,-157704,204756,262948,-58192,215896
2020-02-03,64900,-1000,797729,294998,254957,40041,236999,364071,-127072,87031
2020-01-31,65900,-1300,697360,209059,218966,-9907,155834,306329,-150495,160402
2020-01-30,67200,0,549972,181564,185472,-3908,171571,191968,-20397,24305
2020-01-29,67200,100,585990,261082,222386,38696,108065,251234,-143169,104473
2020-01-28,67100,-1900,729302,335301,252273,83028,60852,205247,-144395,61367
2020-01-23,69000,-1400,604024,188541,250345,-61804,87948,251206,-163258,225062
2020-01-22,70400,300,546215,191653,126944,64709,129572,203193,-73621,8912
2020-01-21,70100,-1100,379059,110167,140738,-30571,73098,90771,-17673,48244
2020-01-20,71200,2000,894609,269546,179618,89928,370774,121773,249001,-338929
2020-01-17,69200,-700,464204,120283,210040,-89757,116574,105391,11183,78574
2020-01-16,69900,300,440562,116680,144851,-28171,181398,112344,69054,-40883
2020-01-15,69600,1300,698052,204645,163254,41391,279586,193648,85938,-127329
2020-01-14,68300,1700,1081428,381049,347752,33297,250999,240178,10821,-44118
2020-01-13,66600,-200,600906,164831,259737,-94906,69176,202828,-133652,228558
2020-01-10,66800,200,797710,209509,290128,-80619,189501,288439,-98938,179557
2020-01-09,66600,-900,1565867,411415,650378,-238963,231947,584492,-352545,591508
2020-01-08,67500,-2800,937438,226543,445679,-219136,305120,227983,77137,141999
2020-01-07,70300,400,265311,77886,115138,-37252,105048,53936,51112,-13860
2020-01-06,69900,-1200,337026,130010,146783,-16773,65264,49875,15389,1384
2020-01-03,71100,100,369493,135048,233436,-98388,102228,56591,45637,52751
2020-01-02,71000,-1100,284758,87761,140782,-53021,53431,66674,-13243,66264
2019-12-30,72100,300,283273,64743,53961,10782,160293,153241,7052,-17834
2019-12-27,71800,500,498244,127698,178544,-50846,183686,212369,-28683,79529
2019-12-26,71300,-600,372424,141755,72202,69553,58833,54974,3859,-73412
2019-12-24,71900,-600,220741,119619,71529,48090,46492,35492,11000,-59090
2019-12-23,72500,0,257344,129620,93044,36576,56787,36310,20477,-57053
2019-12-20,72500,0,403031,59292,68203,-8911,234589,199710,34879,-25968
2019-12-19,72500,0,302037,70530,100947,-30417,166164,72859,93305,-62888
2019-12-18,72500,100,399504,131322,139186,-7864,175607,105805,69802,-61938
2019-12-17,72400,400,455261,135774,145618,-9844,180954,123187,57767,-47923
2019-12-16,72000,-200,271523,140633,63338,77295,80867,116368,-35501,-41794
2019-12-13,72200,500,405472,156541,88632,67909,142502,149655,-7153,-60756
2019-12-12,71700,500,979009,476645,342579,134066,418059,358294,59765,-193831
2019-12-11,71200,0,339949,118056,114941,3115,109918,108647,1271,-4386
2019-12-10,71200,2100,575566,136342,205783,-69441,367185,48188,318997,-249556
2019-12-09,69100,-1100,436982,121555,183772,-62217,98388,147144,-48756,110973
2019-12-06,70200,200,272392,75395,88864,-13469,130958,113308,17650,-4181
2019-12-05,70000,0,295956,78457,123394,-44937,140516,103877,36639,8298
2019-12-04,70000,-500,294889,121278,108805,12473,113491,118206,-4715,-7758
2019-12-03,70500,200,217447,90465,76590,13875,101479,39350,62129,-76004
2019-12-02,70300,400,237237,92770,80302,12468,92059,80108,11951,-24419
2019-11-29,69900,-1100,350465,149617,139885,9732,59467,116627,-57160,47428
2019-11-28,71000,-500,259491,106437,91898,14539,16775,54946,-38171,23632
2019-11-27,71500,600,292977,105157,106078,-921,104580,50684,53896,-52975
2019-11-26,70900,-500,697121,246028,105921,140107,348968,428926,-79958,-60149
2019-11-25,71400,1300,380355,182143,129237,52906,120010,95451,24559,-77465
2019-11-22,70100,-300,267673,106617,97509,9108,58898,84831,-25933,16825
2019-11-21,70400,-500,475086,175025,120241,54784,159660,163922,-4262,-50522
2019-11-20,70900,-1000,479826,149388,124588,24800,132346,208923,-76577,51777
2019-11-19,71900,400,538536,240143,171428,68715,126482,80545,45937,-114652
2019-11-18,71500,1000,609015,286077,129931,156146,129671,94998,34673,-190819
2019-11-15,70500,1500,728818,266391,89673,176718,304650,96669,207981,-384699
2019-11-14,69000,200,305427,205130,180635,24495,74252,43867,30385,-54880
2019-11-13,68800,-200,366473,93131,142073,-48942,168553,139600,28953,19989
2019-11-12,69000,-300,311635,101195,111605,-10410,110322,118278,-7956,18366
2019-11-11,69300,-100,278287,130811,94311,36500,86010,80914,5096,-41596
합계,,,228168613,64750448,63447397,1303051,51872266,48729771,3142495,-4445546
