날짜,종가,대비,거래량,기관 매수,기관 매도,기관 순매수,외국인 매수,외국인 매도,외국인 순매수,개인 순매수
2020-11-11,692000,-10000,528736,148378,162920,-14542,181923,172537,9386,5156
2020-11-10,702000,-32000,563688,136629,191701,-55072,108232,156277,-48045,103117
2020-11-09,734000,14000,601476,202293,159584,42709,138896,135442,3454,-46163
2020-11-06,720000,43000,1268197,321295,224882,96413,609680,90228,519452,-615865
2020-11-05,677000,27000,446583,165063,103703,61360,169737,24753,144984,-206344
2020-11-04,650000,-6000,472730,151251,163877,-12626,126449,108444,18005,-5379
2020-11-03,656000,33000,638480,202196,162437,39759,295527,40032,255495,-295254
2020-11-02,623000,12000,505856,127849,178817,-50968,162117,50512,111605,-60637
2020-10-30,611000,-40000,820454,178619,244331,-65712,215036,239175,-24139,89851
2020-10-29,651000,9000,386081,114444,106926,7518,166170,66682,99488,-107006
2020-10-28,642000,10000,368105,67140,147413,-80273,116267,47214,69053,11220
2020-10-27,632000,-14000,261388,79605,111873,-32268,91972,64380,27592,4676
2020-10-26,646000,-4000,264208,70121,96175,-26054,118585,59067,59518,-33464
2020-10-23,650000,11000,405718,75575,111552,-35977,235942,97555,138387,-102410
2020-10-22,639000,22000,512433,138062,151005,-12943,235893,85939,149954,-137011
2020-10-21,617000,-4000,241633,77692,96043,-18351,69057,62129,6928,11423
2020-10-20,621000,6000,483397,134985,111947,23038,157477,200186,-42709,19671
2020-10-19,615000,-25000,473127,133432,214821,-81389,83377,81642,1735,79654
2020-10-16,640000,3000,310579,120916,131585,-10669,88304,37098,51206,-40537
2020-10-15,637000,9000,531454,122247,153518,-31271,228829,87157,141672,-110401
2020-10-14,628000,-16000,725349,121300,239154,-117854,223257,204570,18687,99167
2020-10-13,644000,-28000,678451,97242,272663,-175421,72841,86769,-13928,189349
2020-10-12,672000,-20000,551057,121110,173640,-52530,110527,100553,9974,42556
2020-10-08,692000,12000,564700,147943,205330,-57387,208328,46842,161486,-104099
2020-10-07,680000,6000,294545,88454,67497,20957,106472,52657,53815,-74772
2020-10-06,674000,15000,451956,118834,90130,28704,189229,50548,138681,-167385
2020-10-05,659000,5000,443499,102090,86707,15383,207919,136862,71057,-86440
2020-09-29,654000,28000,677451,138300,156793,-18493,285222,111707,173515,-155022
2020-09-28,626000,-1000,367111,74058,66273,7785,105959,98250,7709,-15494
2020-09-25,627000,16000,493489,119405,101472,17933,171182,94592,76590,-94523
2020-09-24,611000,-19000,872924,192739,199289,-6550,311505,192445,119060,-112510
2020-09-23,630000,-9000,1271568,265729,343801,-78072,232207,236873,-4666,82738
2020-09-22,639000,12000,1209481,242816,217989,24827,309595,160219,149376,-174203
2020-09-21,627000,-39000,1239438,212299,192269,20030,241380,186032,55348,-75378
2020-09-18,666000,21000,1775061,324412,357011,-32599,436756,230785,205971,-173372
2020-09-17,645000,-42000,3408145,495678,440274,55404,442057,280300,161757,-217161
2020-09-16,687000,-39000,958233,120106,179267,-59161,115534,71987,43547,15614
2020-09-15,726000,14000,435166,84088,78153,5935,90947,80226,10721,-16656
2020-09-14,712000,7000,327850,72987,84281,-11294,34648,32483,2165,9129
2020-09-11,705000,-8000,361882,46775,100875,-54100,52708,91682,-38974,93074
2020-09-10,713000,14000,541097,121607,180479,-58872,119674,137712,-18038,76910
2020-09-09,699000,-10000,575376,82783,130256,-47473,141384,169847,-28463,75936
2020-09-08,709000,-11000,811834,182172,182446,-274,113947,173515,-59568,59842
2020-09-07,720000,-23000,635302,71913,142695,-70782,48175,172131,-123956,194738
2020-09-04,743000,-25000,773517,70076,217577,-147501,86359,207135,-120776,268277
2020-09-03,768000,26000,690256,138893,169065,-30172,169325,75023,94302,-64130
2020-09-02,742000,-1000,462821,96248,152798,-56550,81220,100809,-19589,76139
2020-09-01,743000,3000,645681,173694,187928,-14234,92577,130562,-37985,52219
2020-08-31,740000,-19000,835300,221416,210201,11215,84549,237785,-153236,142021
2020-08-28,759000,-3000,496857,139141,132315,6826,36799,64995,-28196,21370
2020-08-27,762000,5000,1060767,241647,256253,-14606,111765,128262,-16497,31103
2020-08-26,757000,44000,1094918,295349,197331,98018,204587,91406,113181,-211199
2020-08-25,713000,11000,450237,160322,136596,23726,89514,42775,46739,-70465
2020-08-24,702000,3000,574924,178855,173763,5092,83304,83294,10,-5102
2020-08-21,699000,32000,1078744,270232,187012,83220,146557,118469,28088,-111308
2020-08-20,667000,-16000,841507,224754,209145,15609,136797,149212,-12415,-3194
2020-08-19,683000,-7000,746732,154318,153696,622,94281,227851,-133570,132948
2020-08-18,690000,-10000,1051815,219844,159121,60723,239173,235321,3852,-64575
2020-08-14,700000,-37000,1160403,104273,209824,-105551,136125,383001,-246876,352427
2020-08-13,737000,-4000,970866,215759,192156,23603,130173,229982,-99809,76206
2020-08-12,741000,-17000,673527,128204,116975,11229,52430,180188,-127758,116529
2020-08-11,758000,38000,1087515,147562,204995,-57433,249266,160569,88697,-31264
2020-08-10,720000,-26000,1035305,132286,168907,-36621,75115,332631,-257516,294137
2020-08-07,746000,66000,1399982,168860,276019,-107159,246307,215649,30658,76501
2020-08-06,680000,10000,634951,131940,128434,3506,111847,145494,-33647,30141
2020-08-05,670000,28000,917661,130779,186843,-56064,150317,134545,15772,40292
2020-08-04,642000,7000,894736,106629,217718,-111089,195188,169574,25614,85475
2020-08-03,635000,67000,1715295,219341,381086,-161745,377992,220582,157410,4335
2020-07-31,568000,38000,1376453,320608,179621,140987,376914,114345,262569,-403556
2020-07-30,530000,3000,244581,73018,72624,394,32002,64819,-32817,32423
2020-07-29,527000,-1000,315710,86173,118268,-32095,63261,44626,18635,13460
2020-07-28,528000,11000,372041,101056,119565,-18509,119395,16596,102799,-84290
2020-07-27,517000,1000,257568,81154,39612,41542,46205,103071,-56866,15324
2020-07-24,516000,-16000,406633,43210,107090,-63880,75539,134783,-59244,123124
2020-07-23,532000,5000,270382,93640,87850,5790,27933,16050,11883,-17673
2020-07-22,527000,-4000,332150,53279,92878,-39599,85787,80625,5162,34437
2020-07-21,531000,20000,489307,97749,100068,-2319,167395,38503,128892,-126573
2020-07-20,511000,-5000,318383,54126,101779,-47653,83117,66954,16163,31490
2020-07-17,516000,-7000,540426,94165,95016,-851,115857,191036,-75179,76030
2020-07-16,523000,-21000,504937,68145,131202,-63057,43538,127567,-84029,147086
2020-07-15,544000,10000,341645,77572,74455,3117,112574,43157,69417,-72534
2020-07-14,534000,-13000,441154,61689,117746,-56057,43625,151126,-107501,163558
2020-07-13,547000,18000,368579,81819,77794,4025,72309,58718,13591,-17616
2020-07-10,529000,-10000,470969,86358,101589,-15231,44145,164254,-120109,135340
2020-07-09,539000,26000,819218,252761,237227,15534,165078,63786,101292,-116826
2020-07-08,513000,-3000,358194,79736,118736,-39000,68134,122354,-54220,93220
2020-07-07,516000,7000,630054,201656,127678,73978,118996,104029,14967,-88945
2020-07-06,509000,2000,317805,94215,48850,45365,39142,74780,-35638,-9727
2020-07-03,507000,11000,443404,110407,87277,23130,87798,34835,52963,-76093
2020-07-02,496000,4500,362498,115682,62898,52784,95568,173385,-77817,25033
2020-07-01,491500,1000,357203,129303,96592,32711,41205,46316,-5111,-27600
2020-06-30,490500,1000,443059,147789,127882,19907,54858,101988,-47130,27223
2020-06-29,489500,-11500,454763,115464,195437,-79973,75301,52734,22567,57406
2020-06-26,501000,2000,473636,97524,142673,-45149,83125,58910,24215,20934
2020-06-25,499000,-17000,551096,59444,198756,-139312,53080,81928,-28848,168160
2020-06-24,516000,12000,391402,85128,60059,25069,75442,74570,872,-25941
2020-06-23,504000,-2000,516968,109148,89170,19978,61514,132445,-70931,50953
2020-06-22,506000,-6000,509229,97084,77867,19217,43405,142244,-98839,79622
2020-06-19,512000,21000,738862,147396,120519,26877,171650,121574,50076,-76953
2020-06-18,491000,-500,509457,145248,137348,7900,127719,153436,-25717,17817
2020-06-17,491500,4000,1390544,293763,307668,-13905,325451,359851,-34400,48305
2020-06-16,487500,59500,1156149,318395,212419,105976,305418,94225,211193,-317169
2020-06-15,428000,-34000,851192,205169,250342,-45173,148389,138298,10091,35082
2020-06-12,462000,-1000,1007453,273814,226302,47512,124902,222487,-97585,50073
2020-06-11,463000,23000,1250374,389222,401427,-12205,334237,149313,184924,-172719
2020-06-10,440000,7500,535589,189730,121506,68224,172588,146903,25685,-93909
2020-06-09,432500,-1500,609988,190042,154118,35924,76853,199047,-122194,86270
2020-06-08,434000,0,684281,150807,198137,-47330,178955,152995,25960,21370
2020-06-05,434000,16500,865564,262623,146545,116078,200705,97589,103116,-219194
2020-06-04,417500,17000,966577,378724,233936,144788,156307,82440,73867,-218655
2020-06-03,400500,5500,474692,198332,145251,53081,99514,32156,67358,-120439
2020-06-02,395000,-1000,390982,143811,138712,5099,69863,79393,-9530,4431
2020-06-01,396000,5500,401656,183485,153939,29546,56742,35776,20966,-50512
2020-05-29,390500,2000,526505,186242,173673,12569,165054,158809,6245,-18814
2020-05-28,388500,-7000,842769,252506,263832,-11326,136097,234961,-98864,110190
2020-05-27,395500,-18500,622426,156679,169702,-13023,73267,153365,-80098,93121
2020-05-26,414000,24500,958956,308396,185932,122464,191733,42304,149429,-271893
2020-05-25,389500,12500,505854,206717,130407,76310,63036,25454,37582,-113892
2020-05-22,377000,-500,504011,164330,107981,56349,67345,99459,-32114,-24235
2020-05-21,377500,15000,1033430,276849,147097,129752,270162,74433,195729,-325481
2020-05-20,362500,5500,358098,111514,70124,41390,79196,40014,39182,-80572
2020-05-19,357000,3000,395494,147838,79110,68728,52071,56079,-4008,-64720
2020-05-18,354000,7500,408948,139749,77377,62372,69636,46281,23355,-85727
2020-05-15,346500,2000,364374,120543,75233,45310,115529,152667,-37138,-8172
2020-05-14,344500,-7500,399418,124909,108872,16037,49992,90271,-40279,24242
2020-05-13,352000,14000,861294,233971,133754,100217,216490,329849,-113359,13142
2020-05-12,338000,-8500,554982,73201,92972,-19771,96825,221769,-124944,144715
2020-05-11,346500,-6000,629395,99623,122516,-22893,86412,304274,-217862,240755
2020-05-08,352500,-1500,678484,120340,122152,-1812,79585,286765,-207180,208992
2020-05-07,354000,-7000,431374,55615,80713,-25098,72520,151044,-78524,103622
2020-05-06,361000,1000,344167,77503,80578,-3075,58420,122477,-64057,67132
2020-05-04,360000,-16500,669179,89923,156905,-66982,101882,288184,-186302,253284
2020-04-29,376500,14000,566265,100454,91477,8977,263219,49501,213718,-222695
2020-04-28,362500,9000,582497,169639,124682,44957,162620,110147,52473,-97430
2020-04-27,353500,0,445576,115377,63314,52063,153745,241297,-87552,35489
2020-04-24,353500,-7500,270535,63037,89927,-26890,45058,57284,-12226,39116
2020-04-23,361000,6000,343123,134942,77016,57926,62732,66549,-3817,-54109
2020-04-22,355000,1000,362008,96630,101223,-4593,44921,75113,-30192,34785
2020-04-21,354000,2500,710608,187885,153478,34407,175768,215488,-39720,5313
2020-04-20,351500,-11000,504864,114176,117593,-3417,50500,169140,-118640,122057
2020-04-17,362500,19500,753764,142578,132797,9781,146941,63519,83422,-93203
2020-04-16,343000,16500,621763,169310,108154,61156,143939,117049,26890,-88046
2020-04-14,326500,11500,436161,121558,79471,42087,119777,60792,58985,-101072
2020-04-13,315000,-9000,298575,52032,97687,-45655,50376,47055,3321,42334
2020-04-10,324000,-500,313697,70623,80459,-9836,49221,49215,6,9830
2020-04-09,324500,11500,470177,144568,125423,19145,121246,67000,54246,-73391
2020-04-08,313000,4000,616801,143184,114342,28842,135489,79956,55533,-84375
2020-04-07,309000,12500,717617,105774,135329,-29555,317570,160439,157131,-127576
2020-04-06,296500,6000,494846,145314,69759,75555,115335,208238,-92903,17348
2020-04-03,290500,-500,540101,125211,109664,15547,75592,165783,-90191,74644
2020-04-02,291000,-1000,688886,172282,201370,-29088,120099,239498,-119399,148487
2020-04-01,292000,-13000,599459,130418,169906,-39488,127529,261812,-134283,173771
2020-03-31,305000,2000,492967,107686,186275,-78589,143560,86368,57192,21397
2020-03-30,303000,-500,473701,161292,136229,25063,96162,114542,-18380,-6683
2020-03-27,303500,4000,648602,171415,177555,-6140,147456,122842,24614,-18474
2020-03-26,299500,-8000,720792,157855,161543,-3688,119144,283592,-164448,168136
2020-03-25,307500,19500,803831,148815,130914,17901,167894,145632,22262,-40163
2020-03-24,288000,20000,966345,181927,136943,44984,163714,248430,-84716,39732
2020-03-23,268000,-4500,947838,130524,136104,-5580,195292,202828,-7536,13116
2020-03-20,272500,42500,1306067,308548,229118,79430,344478,363125,-18647,-60783
2020-03-19,230000,-50000,1394682,251865,283979,-32114,265486,535113,-269627,301741
2020-03-18,280000,-26500,946373,95059,193448,-98389,290900,416754,-125854,224243
2020-03-17,306500,-6000,819960,251624,230592,21032,192297,280820,-88523,67491
2020-03-16,312500,-28000,747892,138840,207110,-68270,226475,279638,-53163,121433
2020-03-13,340500,-1000,899561,234886,190622,44264,287816,349976,-62160,17896
2020-03-12,341500,-23500,1041370,217856,189449,28407,361034,539330,-178296,149889
2020-03-11,365000,-8500,447847,95782,128621,-32839,127385,113055,14330,18509
2020-03-10,373500,-500,660399,167539,128133,39406,181236,317365,-136129,96723
2020-03-09,374000,-26000,611394,122703,178892,-56189,122843,244866,-122023,178212
2020-03-06,400000,-6000,357631,120220,110189,10031,111085,145435,-34350,24319
2020-03-05,406000,14000,645954,113652,150752,-37100,362532,245768,116764,-79664
2020-03-04,392000,5500,478790,144167,142805,1362,154003,200736,-46733,45371
2020-03-03,386500,9500,547921,180650,223444,-42794,131515,126580,4935,37859
2020-03-02,377000,9000,514325,169977,153273,16704,152042,173413,-21371,4667
2020-02-28,368000,-20000,643995,181098,194996,-13898,234323,227414,6909,6989
2020-02-27,388000,-7000,345104,146886,135855,11031,82322,72710,9612,-20643
2020-02-26,395000,-4500,334971,116446,112609,3837,121016,131825,-10809,6972
2020-02-25,399500,4500,478820,98950,100103,-1153,202337,244864,-42527,43680
2020-02-24,395000,-12000,463848,134649,126536,8113,169770,164278,5492,-13605
2020-02-21,407000,-12000,400924,121729,135714,-13985,121317,140135,-18818,32803
2020-02-20,419000,15000,482732,133774,151169,-17395,207257,69946,137311,-119916
2020-02-19,404000,-14000,766920,182373,203558,-21185,254306,320167,-65861,87046
2020-02-18,418000,-1500,366288,79938,98006,-18068,180076,151507,28569,-10501
2020-02-17,419500,6000,514355,130852,105158,25694,169822,218162,-48340,22646
2020-02-14,413500,2000,301730,86540,88104,-1564,112196,109499,2697,-1133
2020-02-13,411500,3500,448366,120356,108475,11881,194186,189867,4319,-16200
2020-02-12,408000,-5500,463511,122703,104379,18324,173130,225299,-52169,33845
2020-02-11,413500,26500,983089,241092,147473,93619,371376,232658,138718,-232337
2020-02-10,387000,500,291904,80088,58389,21699,123244,134854,-11610,-10089
2020-02-07,386500,4500,392312,95686,97427,-1741,157495,89336,68159,-66418
2020-02-06,382000,0,551088,130383,127323,3060,269333,234439,34894,-37954
2020-02-05,382000,2500,731711,130172,217108,-86936,406060,234517,171543,-84607
2020-02-04,379500,29500,995237,226144,233969,-7825,503847,235738,268109,-260284
2020-02-03,350000,12500,594448,209064,140429,68635,261422,234956,26466,-95101
2020-01-31,337500,-6000,391298,78694,104838,-26144,190342,150469,39873,-13729
2020-01-30,343500,8500,642288,118336,136558,-18222,408142,327053,81089,-62867
2020-01-29,335000,-1500,272147,86257,90124,-3867,106531,121411,-14880,18747
2020-01-28,336500,-12000,348298,100177,82363,17814,101217,149050,-47833,30019
2020-01-23,348500,-3000,260932,82668,101288,-18620,88743,77827,10916,7704
2020-01-22,351500,7000,311524,108707,48535,60172,101980,173316,-71336,11164
2020-01-21,344500,-9500,364883,67929,44295,23634,158980,213805,-54825,31191
2020-01-20,354000,21000,556519,169956,83198,86758,190959,102580,88379,-175137
2020-01-17,333000,4000,221203,31319,49432,-18113,146322,95584,50738,-32625
2020-01-16,329000,500,194414,50145,58420,-8275,84730,93897,-9167,17442
2020-01-15,328500,-5000,231766,63448,50810,12638,82421,126986,-44565,31927
2020-01-14,333500,1000,425340,61270,87711,-26441,234841,176872,57969,-31528
2020-01-13,332500,7500,359435,97752,63483,34269,153350,99235,54115,-88384
2020-01-10,325000,18500,610981,181835,90927,90908,316526,146428,170098,-261006
2020-01-09,306500,4500,198621,56133,64634,-8501,85602,95086,-9484,17985
2020-01-08,302000,-9000,225471,40693,68063,-27370,36563,103032,-66469,93839
2020-01-07,311000,4000,133788,43903,33899,10004,62460,35348,27112,-37116
2020-01-06,307000,-4000,138154,38577,44799,-6222,43921,46953,-3032,9254
2020-01-03,311000,-3000,165030,45297,69198,-23901,63185,61456,1729,22172
2020-01-02,314000,-3500,139496,34602,55636,-21034,37269,47217,-9948,30982
2019-12-30,317500,7000,168990,51910,23655,28255,69396,47657,21739,-49994
2019-12-27,310500,2500,149622,38617,68287,-29670,38110,28366,9744,19926
2019-12-26,308000,-4500,166208,39949,56007,-16058,16045,13803,2242,13816
2019-12-24,312500,-500,224260,65003,67975,-2972,78795,30445,48350,-45378
2019-12-23,313000,-1500,121761,48442,37741,10701,34029,26641,7388,-18089
2019-12-20,314500,5500,248130,55954,39766,16188,137746,73123,64623,-80811
2019-12-19,309000,2000,110138,29535,26949,2586,48795,38286,10509,-13095
2019-12-18,307000,1500,207013,36383,66905,-30522,113340,91890,21450,9072
2019-12-17,305500,-3500,176726,46697,44947,1750,81122,94358,-13236,11486
2019-12-16,309000,6000,182481,60796,39268,21528,88643,60472,28171,-49699
2019-12-13,303000,2500,223170,78156,47254,30902,77827,118460,-40633,9731
2019-12-12,300500,0,246964,126176,147329,-21153,91191,63521,27670,-6517
2019-12-11,300500,1500,137285,39026,43990,-4964,56400,69244,-12844,17808
2019-12-10,299000,4000,159077,41175,20138,21037,64824,95586,-30762,9725
2019-12-09,295000,500,150943,62013,40400,21613,42840,79946,-37106,15493
2019-12-06,294500,1000,155425,36179,53605,-17426,66515,63895,2620,14806
2019-12-05,293500,-3000,199730,28288,85214,-56926,85521,85590,-69,56995
2019-12-04,296500,-13000,316394,55693,144050,-88357,55970,137617,-81647,170004
2019-12-03,309500,500,97676,41430,45178,-3748,40125,29285,10840,-7092
2019-12-02,309000,2500,123351,47054,35626,11428,59676,62173,-2497,-8931
2019-11-29,306500,-2500,197050,51809,62619,-10810,110503,111368,-865,11675
2019-11-28,309000,0,87936,28901,25225,3676,44124,41485,2639,-6315
2019-11-27,309000,500,100282,32735,30572,2163,48574,44617,3957,-6120
2019-11-26,308500,0,302933,63805,40689,23116,218832,232907,-14075,-9041
2019-11-25,308500,7500,300005,69407,42062,27345,186144,194668,-8524,-18821
2019-11-22,301000,-4000,285700,56382,32910,23472,159447,226242,-66795,43323
2019-11-21,305000,-4500,156773,56651,46974,9677,43119,77855,-34736,25059
2019-11-20,309500,-8000,188995,43882,50580,-6698,48290,98676,-50386,57084
2019-11-19,317500,1500,136513,47766,42005,5761,59481,55605,3876,-9637
2019-11-18,316000,-1500,88958,30217,22814,7403,29121,47384,-18263,10860
2019-11-15,317500,-2000,130953,63107,30764,32343,22378,73278,-50900,18557
2019-11-14,319500,5000,135926,85075,62014,23061,36170,35368,802,-23863
2019-11-13,314500,-3000,117232,31764,34755,-2991,49936,37162,12774,-9783
2019-11-12,317500,500,62703,23340,19217,4123,24445,29858,-5413,1290
2019-11-11,317000,-6000,124161,44770,40250,4520,35955,50921,-14966,10446
합계,,,137187540,32331747,32436756,-105009,34817651,33610237,1207414,-1102405
