날짜,종가,대비,거래량,기관 매수,기관 매도,기관 순매수,외국인 매수,외국인 매도,외국인 순매수,개인 순매수
2020-11-11,238500,1500,394571,227139,111880,115259,107648,163668,-56020,-59239
2020-11-10,237000,3000,465479,195634,149026,46608,180384,112899,67485,-114093
2020-11-09,234000,6000,346313,162017,137702,24315,110782,49086,61696,-86011
2020-11-06,228000,1000,292212,133812,114342,19470,97092,83437,13655,-33125
2020-11-05,227000,8000,492058,196742,162481,34261,203502,117928,85574,-119835
2020-11-04,219000,-1500,317582,168511,149228,19283,78307,77217,1090,-20373
2020-11-03,220500,4500,317709,160203,67084,93119,114884,87019,27865,-120984
2020-11-02,216000,8000,442086,220150,153415,66735,160468,140618,19850,-86585
2020-10-30,208000,-4000,369989,136121,122416,13705,150225,162935,-12710,-995
2020-10-29,212000,-4000,450580,119218,127973,-8755,202421,171727,30694,-21939
2020-10-28,216000,-4000,298845,117391,92678,24713,77766,142334,-64568,39855
2020-10-27,220000,2000,511872,132221,139788,-7567,309849,276042,33807,-26240
2020-10-26,218000,-2000,600037,255318,230084,25234,126552,212003,-85451,60217
2020-10-23,220000,10000,903396,534850,290407,244443,147669,141915,5754,-250197
2020-10-22,210000,3000,463459,177434,88887,88547,221941,231187,-9246,-79301
2020-10-21,207000,500,249347,129874,96424,33450,54688,109652,-54964,21514
2020-10-20,206500,-2000,350583,173734,87259,86475,66696,185119,-118423,31948
2020-10-19,208500,6500,424316,314458,119946,194512,54841,100861,-46020,-148492
2020-10-16,202000,-3000,269441,127199,82693,44506,59970,122503,-62533,18027
2020-10-15,205000,4500,309713,162520,76567,85953,87927,82234,5693,-91646
2020-10-14,200500,-4500,300335,108160,91917,16243,94652,143804,-49152,32909
2020-10-13,205000,-2000,190587,96168,89063,7105,39775,54465,-14690,7585
2020-10-12,207000,-1000,269502,107167,92296,14871,43446,125090,-81644,66773
2020-10-08,208000,3000,554481,231012,191163,39849,188621,102132,86489,-126338
2020-10-07,205000,3000,294582,163965,92323,71642,59297,83368,-24071,-47571
2020-10-06,202000,-3000,277292,128713,71303,57410,68749,118412,-49663,-7747
2020-10-05,205000,9000,723156,306726,137718,169008,316501,146203,170298,-339306
2020-09-29,196000,2000,351353,156918,59115,97803,132358,178156,-45798,-52005
2020-09-28,194000,0,243804,141706,79732,61974,51918,73027,-21109,-40865
2020-09-25,194000,6000,348033,173804,87919,85885,111413,135846,-24433,-61452
2020-09-24,188000,-7000,369215,133096,138528,-5432,50300,140729,-90429,95861
2020-09-23,195000,500,450482,250183,166359,83824,60123,159471,-99348,15524
2020-09-22,194500,3500,953120,560929,236146,324783,191354,319066,-127712,-197071
2020-09-21,191000,-1000,358087,180838,93713,87125,79868,137800,-57932,-29193
2020-09-18,192000,2000,522946,214227,123910,90317,172457,195403,-22946,-67371
2020-09-17,190000,1000,299058,101598,95783,5815,120893,114219,6674,-12489
2020-09-16,189000,-500,200188,90520,83080,7440,38111,63442,-25331,17891
2020-09-15,189500,-500,276837,101023,100121,902,77895,94868,-16973,16071
2020-09-14,190000,4500,258053,108808,76850,31958,85258,72352,12906,-44864
2020-09-11,185500,0,202517,76386,73297,3089,47833,86753,-38920,35831
2020-09-10,185500,500,412264,212633,182367,30266,103997,159370,-55373,25107
2020-09-09,185000,-2000,326016,81670,116233,-34563,83629,152863,-69234,103797
2020-09-08,187000,-1000,268589,101311,96939,4372,45702,115188,-69486,65114
2020-09-07,188000,2000,316466,170537,110158,60379,59823,108457,-48634,-11745
2020-09-04,186000,-3000,285469,79413,112046,-32633,106043,98584,7459,25174
2020-09-03,189000,1000,263157,106720,109818,-3098,62184,88893,-26709,29807
2020-09-02,188000,1500,220654,93049,69088,23961,51409,106715,-55306,31345
2020-09-01,186500,2000,323816,126505,121383,5122,122904,154911,-32007,26885
2020-08-31,184500,-5000,542851,176099,146039,30060,201931,333960,-132029,101969
2020-08-28,189500,1000,377563,176365,116318,60047,122242,173130,-50888,-9159
2020-08-27,188500,-4500,432450,82647,158741,-76094,69334,132453,-63119,139213
2020-08-26,193000,-7500,512515,91281,172092,-80811,88285,239586,-151301,232112
2020-08-25,200500,1500,223434,81948,95513,-13565,68446,66218,2228,11337
2020-08-24,199000,0,205330,96934,91032,5902,48707,52565,-3858,-2044
2020-08-21,199000,4000,257961,136195,102417,33778,73725,53372,20353,-54131
2020-08-20,195000,-6000,373768,167954,216706,-48752,87557,31487,56070,-7318
2020-08-19,201000,-2000,220589,99909,91012,8897,24039,41840,-17801,8904
2020-08-18,203000,-7500,437588,195006,148793,46213,121561,120982,579,-46792
2020-08-14,210500,4500,438014,216456,145955,70501,63532,77662,-14130,-56371
2020-08-13,206000,-2500,397625,189699,145740,43959,82286,138126,-55840,11881
2020-08-12,208500,1500,360782,138381,101323,37058,55616,86835,-31219,-5839
2020-08-11,207000,8500,655895,241066,183133,57933,190717,59602,131115,-189048
2020-08-10,198500,1500,302994,135469,128990,6479,46851,57053,-10202,3723
2020-08-07,197000,-4000,335833,84282,128775,-44493,71648,85236,-13588,58081
2020-08-06,201000,7000,384949,129352,96622,32730,167763,58272,109491,-142221
2020-08-05,194000,0,196344,66814,103657,-36843,50836,33122,17714,19129
2020-08-04,194000,2000,226337,77984,87237,-9253,81893,74603,7290,1963
2020-08-03,192000,-1500,240285,79641,116687,-37046,83923,68362,15561,21485
2020-07-31,193500,-5500,379886,102319,157656,-55337,136573,139297,-2724,58061
2020-07-30,199000,-2500,361731,97029,140178,-43149,146476,145831,645,42504
2020-07-29,201500,-500,333000,96347,119851,-23504,158994,95059,63935,-40431
2020-07-28,202000,6000,466607,90037,126581,-36544,287558,114292,173266,-136722
2020-07-27,196000,2000,243664,87853,89505,-1652,90000,57588,32412,-30760
2020-07-24,194000,-1500,327478,116476,124909,-8433,132165,70514,61651,-53218
2020-07-23,195500,-2000,444433,151378,213942,-62564,166962,112414,54548,8016
2020-07-22,197500,6000,810125,253874,198117,55757,354220,134235,219985,-275742
2020-07-21,191500,4000,461232,172869,126195,46674,154487,100234,54253,-100927
2020-07-20,187500,1000,198370,77218,84412,-7194,51039,38000,13039,-5845
2020-07-17,186500,0,222271,64778,82572,-17794,90996,65643,25353,-7559
2020-07-16,186500,0,267345,120310,94776,25534,89888,101921,-12033,-13501
2020-07-15,186500,2000,471306,195337,138198,57139,122901,129998,-7097,-50042
2020-07-14,184500,-2500,188702,76688,85731,-9043,54129,66497,-12368,21411
2020-07-13,187000,5000,261632,108311,72230,36081,82762,58723,24039,-60120
2020-07-10,182000,-6500,327123,97841,174341,-76500,38511,81114,-42603,119103
2020-07-09,188500,-2000,375630,164991,198306,-33315,126721,90665,36056,-2741
2020-07-08,190500,5500,537845,173733,158021,15712,275811,106191,169620,-185332
2020-07-07,185000,2000,358072,112384,127825,-15441,185443,93977,91466,-76025
2020-07-06,183000,1500,190812,97539,76997,20542,56482,34919,21563,-42105
2020-07-03,181500,500,189200,84823,86289,-1466,62139,42171,19968,-18502
2020-07-02,181000,2500,252859,85221,144825,-59604,113062,57927,55135,4469
2020-07-01,178500,4500,473226,183645,242535,-58890,229491,47382,182109,-123219
2020-06-30,174000,-1500,415286,119095,187079,-67984,133092,159095,-26003,93987
2020-06-29,175500,-7500,371334,105323,237197,-131874,65645,74150,-8505,140379
2020-06-26,183000,3000,290441,79681,137732,-58051,117134,83260,33874,24177
2020-06-25,180000,-5000,321621,39684,139511,-99827,125734,114518,11216,88611
2020-06-24,185000,2000,284129,98401,134457,-36056,109489,53453,56036,-19980
2020-06-23,183000,-3000,277109,94574,139472,-44898,53272,61548,-8276,53174
2020-06-22,186000,-4500,212866,62397,82120,-19723,68469,82740,-14271,33994
2020-06-19,190500,4000,363079,117827,133106,-15279,189166,132960,56206,-40927
2020-06-18,186500,-500,205015,98843,90634,8209,56203,48825,7378,-15587
2020-06-17,187000,-500,360457,111016,166012,-54996,158962,93780,65182,-10186
2020-06-16,187500,12500,409758,166765,160231,6534,131925,79713,52212,-58746
2020-06-15,175000,-11500,467754,146335,198561,-52226,81926,121788,-39862,92088
2020-06-12,186500,-7000,473608,164887,187467,-22580,83403,99622,-16219,38799
2020-06-11,193500,-4500,637625,284561,376210,-91649,85791,128743,-42952,134601
2020-06-10,198000,-500,357615,127924,166701,-38777,110967,72623,38344,433
2020-06-09,198500,-4000,662411,182186,261733,-79547,155377,122711,32666,46881
2020-06-08,202500,2000,390712,125458,174919,-49461,127961,38255,89706,-40245
2020-06-05,200500,-2500,404474,176432,145345,31087,74152,131580,-57428,26341
2020-06-04,203000,500,666183,218610,229229,-10619,162820,122023,40797,-30178
2020-06-03,202500,13500,1148869,473533,248392,225141,221183,110123,111060,-336201
2020-06-02,189000,6500,552966,216061,177471,38590,169845,113887,55958,-94548
2020-06-01,182500,1500,308421,126901,104510,22391,63459,108429,-44970,22579
2020-05-29,181000,-3500,842257,124117,146929,-22812,559614,564363,-4749,27561
2020-05-28,184500,2000,898715,250135,247298,2837,418656,204618,214038,-216875
2020-05-27,182500,6500,803853,300485,195758,104727,234374,84983,149391,-254118
2020-05-26,176000,4000,460196,172883,151069,21814,148101,102236,45865,-67679
2020-05-25,172000,0,245045,96379,124182,-27803,51992,59205,-7213,35016
2020-05-22,172000,-5000,441297,110176,209211,-99035,76754,115546,-38792,137827
2020-05-21,177000,2500,362478,126553,150979,-24426,118412,100614,17798,6628
2020-05-20,174500,-3500,383809,113110,143137,-30027,66824,133875,-67051,97078
2020-05-19,178000,9000,724613,408588,129671,278917,181438,163133,18305,-297222
2020-05-18,169000,1000,332808,166087,104785,61302,80579,154144,-73565,12263
2020-05-15,168000,0,311479,112227,92180,20047,74409,137657,-63248,43201
2020-05-14,168000,-5000,469714,190039,247716,-57677,69093,157514,-88421,146098
2020-05-13,173000,3000,347924,136815,132775,4040,78652,110018,-31366,27326
2020-05-12,170000,-6000,552954,152808,220791,-67983,88622,177217,-88595,156578
2020-05-11,176000,-4000,323982,95900,153092,-57192,65065,52586,12479,44713
2020-05-08,180000,500,265401,104327,119176,-14849,28065,58212,-30147,44996
2020-05-07,179500,-500,288705,87036,87402,-366,83256,125923,-42667,43033
2020-05-06,180000,1500,369838,98536,93211,5325,156586,165845,-9259,3934
2020-05-04,178500,-6000,635253,143818,226955,-83137,185740,269231,-83491,166628
2020-04-29,184500,7000,614504,203234,158144,45090,227567,141004,86563,-131653
2020-04-28,177500,3500,419709,136118,106715,29403,95128,93219,1909,-31312
2020-04-27,174000,1000,421809,160010,122164,37846,69696,118704,-49008,11162
2020-04-24,173000,1500,387885,106972,135833,-28861,95089,99859,-4770,33631
2020-04-23,171500,1500,339869,124937,117409,7528,66989,74530,-7541,13
2020-04-22,170000,-1000,464539,121186,177555,-56369,76268,149321,-73053,129422
2020-04-21,171000,-4500,560075,166902,193792,-26890,127838,167173,-39335,66225
2020-04-20,175500,-500,390955,129679,169160,-39481,81457,99640,-18183,57664
2020-04-17,176000,0,550330,143751,145381,-1630,90425,195396,-104971,106601
2020-04-16,176000,-7000,653004,185501,174569,10932,149808,315000,-165192,154260
2020-04-14,183000,2000,602681,234292,166819,67473,105141,163336,-58195,-9278
2020-04-13,181000,3000,994277,285191,350547,-65356,194797,183322,11475,53881
2020-04-10,178000,13500,977632,354919,209728,145191,173515,160975,12540,-157731
2020-04-09,164500,3500,650779,221364,283356,-61992,174025,126980,47045,14947
2020-04-08,161000,-500,440329,146570,171099,-24529,95905,123500,-27595,52124
2020-04-07,161500,500,643379,144634,174973,-30339,137173,244952,-107779,138118
2020-04-06,161000,4000,362428,155687,79736,75951,56814,96168,-39354,-36597
2020-04-03,157000,1000,395194,94505,140377,-45872,159958,143168,16790,29082
2020-04-02,156000,1000,478869,145105,167245,-22140,164507,199476,-34969,57109
2020-04-01,155000,-6000,396564,95626,187037,-91411,115355,120478,-5123,96534
2020-03-31,161000,1000,474039,127952,169089,-41137,161307,175277,-13970,55107
2020-03-30,160000,-3500,501851,210186,216714,-6528,75231,179367,-104136,110664
2020-03-27,163500,8000,567062,214248,142829,71419,169189,166381,2808,-74227
2020-03-26,155500,-5500,509091,134966,120778,14188,116249,237716,-121467,107279
2020-03-25,161000,15500,581137,189744,155108,34636,143880,156635,-12755,-21881
2020-03-24,145500,7500,476227,171674,130190,41484,93123,172842,-79719,38235
2020-03-23,138000,-6500,457989,113159,155564,-42405,61041,163266,-102225,144630
2020-03-20,144500,5000,636918,206446,234453,-28007,199372,213702,-14330,42337
2020-03-19,139500,-8000,645668,198294,202023,-3729,227726,189577,38149,-34420
2020-03-18,147500,-8000,559707,137357,203497,-66140,230845,172904,57941,8199
2020-03-17,155500,-6500,547216,169692,205595,-35903,162956,174526,-11570,47473
2020-03-16,162000,-9000,506250,128540,174447,-45907,159855,223534,-63679,109586
2020-03-13,171000,-7000,784135,298117,261129,36988,297947,377416,-79469,42481
2020-03-12,178000,-1500,1019659,368424,438020,-69596,487980,418557,69423,173
2020-03-11,179500,-1000,483620,134186,185514,-51328,243889,183456,60433,-9105
2020-03-10,180500,0,497558,203345,186530,16815,154804,222398,-67594,50779
2020-03-09,180500,-11500,551277,178935,216859,-37924,95414,231360,-135946,173870
2020-03-06,192000,-5000,299607,122681,128131,-5450,67729,132228,-64499,69949
2020-03-05,197000,3000,421898,137305,203480,-66175,172879,154632,18247,47928
2020-03-04,194000,2000,363057,107176,169064,-61888,175248,130900,44348,17540
2020-03-03,192000,500,369345,134226,152066,-17840,138414,140823,-2409,20249
2020-03-02,191500,-4000,437217,149990,172815,-22825,102828,212207,-109379,132204
2020-02-28,195500,-3500,538272,186513,140532,45981,226519,252742,-26223,-19758
2020-02-27,199000,-1000,305381,144762,104371,40391,90460,114457,-23997,-16394
2020-02-26,200000,-2000,339857,126519,127207,-688,92181,147178,-54997,55685
2020-02-25,202000,-1500,306873,126328,134352,-8024,56429,115162,-58733,66757
2020-02-24,203500,-8000,337423,165753,147722,18031,37658,106364,-68706,50675
2020-02-21,211500,-4000,217235,81245,90134,-8889,51212,72888,-21676,30565
2020-02-20,215500,-1000,203605,73115,101910,-28795,68116,60318,7798,20997
2020-02-19,216500,-1000,190216,100320,82435,17885,35001,72586,-37585,19700
2020-02-18,217500,-1000,181856,86583,106066,-19483,49150,49551,-401,19884
2020-02-17,218500,-1000,281494,124233,116358,7875,71111,114084,-42973,35098
2020-02-14,219500,-1500,217419,68846,98781,-29935,71278,71403,-125,30060
2020-02-13,221000,-1000,379379,208072,226886,-18814,88518,103311,-14793,33607
2020-02-12,222000,0,198757,91706,98758,-7052,47058,68199,-21141,28193
2020-02-11,222000,1500,212646,82148,85248,-3100,78015,78651,-636,3736
2020-02-10,220500,-2500,289609,114289,152151,-37862,62575,96113,-33538,71400
2020-02-07,223000,-1000,285403,99837,144447,-44610,122851,99557,23294,21316
2020-02-06,224000,9500,363840,202048,150405,51643,98392,90695,7697,-59340
2020-02-05,214500,500,297540,90635,146887,-56252,120114,116316,3798,52454
2020-02-04,214000,-500,311725,75278,133490,-58212,107654,135168,-27514,85726
2020-02-03,214500,-6500,427513,172439,170421,2018,98546,196203,-97657,95639
2020-01-31,221000,-3500,359322,158430,131033,27397,96877,181186,-84309,56912
2020-01-30,224500,-2000,253901,94481,121275,-26794,111397,63747,47650,-20856
2020-01-29,226500,500,203199,76645,145190,-68545,55952,31191,24761,43784
2020-01-28,226000,-14500,583981,245018,307527,-62509,97134,186812,-89678,152187
2020-01-23,240500,-1000,249642,84441,152148,-67707,128364,64962,63402,4305
2020-01-22,241500,-2500,204013,103102,86970,16132,56725,89350,-32625,16493
2020-01-21,244000,-3000,188964,111362,88442,22920,40698,70066,-29368,6448
2020-01-20,247000,5500,371516,167919,165330,2589,156066,55619,100447,-103036
2020-01-17,241500,0,202782,73634,132927,-59293,91142,43266,47876,11417
2020-01-16,241500,-500,244731,108417,121904,-13487,105298,73248,32050,-18563
2020-01-15,242000,0,205004,68355,104793,-36438,117873,65015,52858,-16420
2020-01-14,242000,3500,253387,99944,102811,-2867,130761,57443,73318,-70451
2020-01-13,238500,1000,206237,76147,112216,-36069,95837,49969,45868,-9799
2020-01-10,237500,3500,248358,93476,149214,-55738,114057,49989,64068,-8330
2020-01-09,234000,6000,337466,149224,205541,-56317,163760,75575,88185,-31868
2020-01-08,228000,-4000,340244,104663,166762,-62099,137651,104535,33116,28983
2020-01-07,232000,1000,138750,51606,73785,-22179,56108,27101,29007,-6828
2020-01-06,231000,-6000,217886,79866,123145,-43279,61515,55410,6105,37174
2020-01-03,237000,1000,273831,122445,144031,-21586,105655,77947,27708,-6122
2020-01-02,236000,-500,213578,95884,113651,-17767,65527,64731,796,16971
2019-12-30,236500,-2000,151194,50755,43302,7453,61303,82940,-21637,14184
2019-12-27,238500,-4500,201365,62204,87072,-24868,47547,88186,-40639,65507
2019-12-26,243000,3000,158756,77363,59796,17567,35525,24764,10761,-28328
2019-12-24,240000,-3500,191559,80149,74849,5300,47101,67173,-20072,14772
2019-12-23,243500,-2500,142015,69316,51589,17727,37248,58872,-21624,3897
2019-12-20,246000,-500,211349,83822,76106,7716,92012,90679,1333,-9049
2019-12-19,246500,-2000,226225,70746,83623,-12877,96474,92873,3601,9276
2019-12-18,248500,1000,256484,38637,77278,-38641,189306,115084,74222,-35581
2019-12-17,247500,5000,369447,115563,90252,25311,215628,142134,73494,-98805
2019-12-16,242500,-500,213258,102289,59131,43158,78592,103704,-25112,-18046
2019-12-13,243000,7500,419459,198178,127850,70328,175478,79380,96098,-166426
2019-12-12,235500,4500,494257,328092,249487,78605,135909,132151,3758,-82363
2019-12-11,231000,-500,188402,86593,63657,22936,73905,94178,-20273,-2663
2019-12-10,231500,-1500,124541,69373,44522,24851,32865,67448,-34583,9732
2019-12-09,233000,2500,156065,80967,62456,18511,57180,38853,18327,-36838
2019-12-06,230500,1500,143898,46299,39484,6815,82411,68472,13939,-20754
2019-12-05,229000,2000,215791,101708,81868,19840,92600,82679,9921,-29761
2019-12-04,227000,-4000,222937,93748,66372,27376,71323,125363,-54040,26664
2019-12-03,231000,-1000,172673,88402,64704,23698,65086,66915,-1829,-21869
2019-12-02,232000,1500,212885,139051,60009,79042,47642,109806,-62164,-16878
2019-11-29,230500,-2000,255848,105403,76474,28929,102046,123507,-21461,-7468
2019-11-28,232500,-500,142160,102545,71830,30715,14755,34900,-20145,-10570
2019-11-27,233000,-500,192708,80280,68162,12118,78500,81200,-2700,-9418
2019-11-26,233500,5500,587228,171573,130369,41204,352883,298898,53985,-95189
2019-11-25,228000,8000,417534,220470,121549,98921,153447,105677,47770,-146691
2019-11-22,220000,-500,187398,75338,69177,6161,45898,98343,-52445,46284
2019-11-21,220500,-2000,252673,110549,95684,14865,57966,91001,-33035,18170
2019-11-20,222500,-3000,232747,100479,92340,8139,50498,99819,-49321,41182
2019-11-19,225500,-2000,215061,72088,99173,-27085,69900,91577,-21677,48762
2019-11-18,227500,3500,207141,78578,69251,9327,69346,59970,9376,-18703
2019-11-15,224000,4000,204292,124241,51581,72660,54816,67371,-12555,-60105
2019-11-14,220000,-1000,233679,149391,136885,12506,29909,70684,-40775,28269
2019-11-13,221000,-2000,170995,97691,88371,9320,34866,44663,-9797,477
2019-11-12,223000,-500,165285,91789,80829,10960,41696,60545,-18849,7889
2019-11-11,223500,-500,171486,83138,65888,17250,57749,58808,-1059,-16191
합계,,,93764326,35474689,34037588,1437101,28406040,29572405,-1166365,-270736
