날짜,종가,대비,거래량,기관 매수,기관 매도,기관 순매수,외국인 매수,외국인 매도,외국인 순매수,개인 순매수
2020-11-11,87000,500,2638617,967653,808978,158675,1060492,718705,341787,-500462
2020-11-10,86500,500,2849783,741434,1324288,-582854,1532873,635836,897037,-314183
2020-11-09,86000,-300,2444330,897306,1104587,-207281,692363,473793,218570,-11289
2020-11-06,86300,200,2863808,1002988,784804,218184,1022018,356074,665944,-884128
2020-11-05,86100,2900,4082325,1648680,797836,850844,1720394,825942,894452,-1745296
2020-11-04,83200,1800,3782296,1775754,1079128,696626,835365,602790,232575,-929201
2020-11-03,81400,1800,2057723,754274,330793,423481,527335,934520,-407185,-16296
2020-11-02,79600,-300,2000394,775729,709152,66577,392042,866336,-474294,407717
2020-10-30,79900,-1800,2710477,441951,787943,-345992,1026134,1290066,-263932,609924
2020-10-29,81700,-1200,2637314,564905,1094118,-529213,645393,851689,-206296,735509
2020-10-28,82900,300,1773556,588973,810988,-222015,616263,471015,145248,76767
2020-10-27,82600,-600,2265817,537942,1101244,-563302,981536,731928,249608,313694
2020-10-26,83200,-700,1662847,615584,595041,20543,405744,538490,-132746,112203
2020-10-23,83900,600,2609595,970519,691321,279198,855503,835014,20489,-299687
2020-10-22,83300,-500,2593975,565375,777731,-212356,908991,1040632,-131641,343997
2020-10-21,83800,-1400,4925877,1264016,966516,297500,1408656,2503452,-1094796,797296
2020-10-20,85200,-1500,6622637,1445052,1545073,-100021,1055246,2213851,-1158605,1258626
2020-10-19,86700,1400,3150011,1353805,1126436,227369,1198006,650588,547418,-774787
2020-10-16,85300,-1800,2435541,739184,833175,-93991,697975,788359,-90384,184375
2020-10-15,87100,600,2802900,877296,776051,101245,1295481,1018201,277280,-378525
2020-10-14,86500,-1700,3223767,929159,863541,65618,980800,1159949,-179149,113531
2020-10-13,88200,2700,6375448,2616518,1005483,1611035,2017161,1418053,599108,-2210143
2020-10-12,85500,2600,4464264,1452804,594946,857858,2185110,768795,1416315,-2274173
2020-10-08,82900,-500,3330824,1223567,1333302,-109735,1277205,1367320,-90115,199850
2020-10-07,83400,400,2254356,987519,629293,358226,816299,1011909,-195610,-162616
2020-10-06,83000,-200,2750145,632429,1171729,-539300,1108392,919508,188884,350416
2020-10-05,83200,-800,3396894,789321,1393154,-603833,1487586,1179856,307730,296103
2020-09-29,84000,1500,4707898,1688754,1250468,438286,2396006,1336508,1059498,-1497784
2020-09-28,82500,-400,3154068,943346,1309488,-366142,944780,875223,69557,296585
2020-09-25,82900,-1400,3205596,1271142,1144025,127117,605476,731150,-125674,-1443
2020-09-24,84300,700,6401560,2892057,1401362,1490695,1966165,1044117,922048,-2412743
2020-09-23,83600,2300,4439085,1883651,1423522,460129,1246427,684816,561611,-1021740
2020-09-22,81300,-3200,4139983,1143437,1467614,-324177,1142568,1129281,13287,310890
2020-09-21,84500,800,4102947,1475177,1004854,470323,1784734,508095,1276639,-1746962
2020-09-18,83700,1500,5199334,1571886,873691,698195,2865150,882201,1982949,-2681144
2020-09-17,82200,700,4055050,1033519,1247154,-213635,2187501,529948,1657553,-1443918
2020-09-16,81500,-400,3119110,968458,797490,170968,997458,698841,298617,-469585
2020-09-15,81900,1900,5899410,1809560,1024674,784886,2416319,748338,1667981,-2452867
2020-09-14,80000,1600,4099644,1249606,740826,508780,1644004,648575,995429,-1504209
2020-09-11,78400,1800,2831262,682444,684445,-2001,1557025,540123,1016902,-1014901
2020-09-10,76600,-700,3541520,759141,1745801,-986660,773784,906275,-132491,1119151
2020-09-09,77300,-2100,3918435,678129,1439305,-761176,1518502,1051431,467071,294105
2020-09-08,79400,1000,3380355,1112603,845831,266772,925298,571655,353643,-620415
2020-09-07,78400,-300,2786930,788320,912007,-123687,713364,913904,-200540,324227
2020-09-04,78700,0,4582566,1682493,1288384,394109,1275675,1318253,-42578,-351531
2020-09-03,78700,3200,7002529,2886190,1400946,1485244,1865384,1886912,-21528,-1463716
2020-09-02,75500,300,2369360,620642,712435,-91793,462350,947297,-484947,576740
2020-09-01,75200,100,2538676,633807,1061456,-427649,728655,812720,-84065,511714
2020-08-31,75100,-2700,5113128,1392527,1709456,-316929,991357,2337379,-1346022,1662951
2020-08-28,77800,-1300,2511956,795643,876101,-80458,467439,636820,-169381,249839
2020-08-27,79100,300,4223450,1416227,1027199,389028,1486378,707375,779003,-1168031
2020-08-26,78800,1800,4741965,2004807,986044,1018763,1283610,552272,731338,-1750101
2020-08-25,77000,1500,3473488,926333,962212,-35879,935655,697395,238260,-202381
2020-08-24,75500,1000,4298619,1179087,1106095,72992,775309,834778,-59469,-13523
2020-08-21,74500,2700,7700029,1585450,1516250,69200,2184974,1178752,1006222,-1075422
2020-08-20,71800,-3200,7260223,1316369,1747643,-431274,962932,1749031,-786099,1217373
2020-08-19,75000,-3100,8028305,724314,2103079,-1378765,933385,3568643,-2635258,4014023
2020-08-18,78100,-2100,4946279,927626,1191305,-263679,883231,1679333,-796102,1059781
2020-08-14,80200,-500,2589552,738473,910574,-172101,176227,600851,-424624,596725
2020-08-13,80700,-300,4049387,1245103,1428022,-182919,560337,1066619,-506282,689201
2020-08-12,81000,-300,3595828,875310,1314148,-438838,303556,1087173,-783617,1222455
2020-08-11,81300,-100,3234013,781417,1046208,-264791,414190,475897,-61707,326498
2020-08-10,81400,800,3277238,985393,904389,81004,461155,326089,135066,-216070
2020-08-07,80600,-500,4946631,362014,1496417,-1134403,1083258,1942274,-859016,1993419
2020-08-06,81100,400,3391939,818957,1103932,-284975,771336,802024,-30688,315663
2020-08-05,80700,-900,4537005,433976,1234881,-800905,798401,2050931,-1252530,2053435
2020-08-04,81600,-200,3005937,533206,1028538,-495332,359064,911194,-552130,1047462
2020-08-03,81800,-1000,3483106,537826,1240186,-702360,597287,875447,-278160,980520
2020-07-31,82800,-2500,4848989,650197,1509627,-859430,598728,1642705,-1043977,1903407
2020-07-30,85300,2100,6870841,1936798,1764002,172796,1817428,887117,930311,-1103107
2020-07-29,83200,100,3719681,742399,978465,-236066,1467080,1476836,-9756,245822
2020-07-28,83100,300,4538720,710359,1357177,-646818,1424135,1536550,-112415,759233
2020-07-27,82800,-900,2784652,545108,835150,-290042,584575,1040004,-455429,745471
2020-07-24,83700,1300,3667416,654004,972829,-318825,1985133,946681,1038452,-719627
2020-07-23,82400,-800,3591647,569737,1169806,-600069,556095,1250641,-694546,1294615
2020-07-22,83200,-900,2876295,542271,802448,-260177,596157,1393915,-797758,1057935
2020-07-21,84100,1900,4181015,1143566,957608,185958,1637414,727168,910246,-1096204
2020-07-20,82200,-700,2008624,420879,775468,-354589,314646,729199,-414553,769142
2020-07-17,82900,200,1579078,445659,605894,-160235,276884,303744,-26860,187095
2020-07-16,82700,-300,2312310,520298,931640,-411342,669244,746431,-77187,488529
2020-07-15,83000,100,3024429,965771,907237,58534,617304,1076361,-459057,400523
2020-07-14,82900,-100,2048671,514805,779709,-264904,303704,553506,-249802,514706
2020-07-13,83000,200,2080934,569478,618181,-48703,286822,723439,-436617,485320
2020-07-10,82800,-200,2201557,560982,1045574,-484592,349428,418977,-69549,554141
2020-07-09,83000,-700,4002365,724211,1715989,-991778,612957,1324527,-711570,1703348
2020-07-08,83700,-1100,3523620,527611,1591194,-1063583,748513,1250932,-502419,1566002
2020-07-07,84800,-1200,3196352,717014,1576293,-859279,866427,585215,281212,578067
2020-07-06,86000,600,2561766,990108,597094,393014,378404,649757,-271353,-121661
2020-07-03,85400,1000,2195897,686579,698510,-11931,875778,529057,346721,-334790
2020-07-02,84400,-900,3295340,808849,1345071,-536222,697716,1317129,-619413,1155635
2020-07-01,85300,200,2382552,1036962,1068539,-31577,530944,440669,90275,-58698
2020-06-30,85100,1500,4983607,2123130,1223401,899729,1486487,1150398,336089,-1235818
2020-06-29,83600,-1000,2932433,1199849,1161959,37890,559088,1046313,-487225,449335
2020-06-26,84600,300,2889494,878524,1109704,-231180,803210,718628,84582,146598
2020-06-25,84300,-1700,3397112,1041257,2064434,-1023177,1314760,697221,617539,405638
2020-06-24,86000,1900,4079834,1487369,1346034,141335,1268747,785509,483238,-624573
2020-06-23,84100,-800,2955819,1005537,1368579,-363042,856047,762366,93681,269361
2020-06-22,84900,-500,2167216,831310,1004900,-173590,694382,522180,172202,1388
2020-06-19,85400,-800,3216102,892056,1356000,-463944,1295899,1231452,64447,399497
2020-06-18,86200,-600,2484147,1159651,1098387,61264,671686,694926,-23240,-38024
2020-06-17,86800,1400,4160612,2122494,1455117,667377,703010,774180,-71170,-596207
2020-06-16,85400,3400,3518785,1727870,1194482,533388,507935,911513,-403578,-129810
2020-06-15,82000,-3200,4710114,1602598,1920588,-317990,755792,1023780,-267988,585978
2020-06-12,85200,-3300,4742329,1157689,2161385,-1003696,905287,721391,183896,819800
2020-06-11,88500,-2300,5467344,1402726,3168142,-1765416,1220848,845229,375619,1389797
2020-06-10,90800,1000,3045250,1308305,1169360,138945,905887,768605,137282,-276227
2020-06-09,89800,-1200,3410081,1223896,1414787,-190891,481107,728422,-247315,438206
2020-06-08,91000,600,3789382,1492490,1635982,-143492,892371,499341,393030,-249538
2020-06-05,90400,2700,4000557,1766358,1134691,631667,794643,446057,348586,-980253
2020-06-04,87700,-1000,6678244,2736934,2031960,704974,866719,1508574,-641855,-63119
2020-06-03,88700,5400,11642239,4476574,1966468,2510106,2533409,1632103,901306,-3411412
2020-06-02,83300,-300,3114162,1103918,1093309,10609,333801,1008974,-675173,664564
2020-06-01,83600,2100,4205357,1705217,868200,837017,1130621,919821,210800,-1047817
2020-05-29,81500,-2400,6815185,1388614,1494035,-105421,2028345,3947787,-1919442,2024863
2020-05-28,83900,2500,9227823,3297627,1354810,1942817,2334444,1246737,1087707,-3030524
2020-05-27,81400,-500,2946278,918864,969283,-50419,505229,731991,-226762,277181
2020-05-26,81900,500,3040122,1128557,1294312,-165755,503774,584644,-80870,246625
2020-05-25,81400,100,2850294,1019791,1245765,-225974,85626,896388,-810762,1036736
2020-05-22,81300,-2100,3471700,914007,1510858,-596851,283566,1095756,-812190,1409041
2020-05-21,83400,-700,2678953,814618,1043750,-229132,724361,589044,135317,93815
2020-05-20,84100,1400,3924403,1176853,1012040,164813,2125648,824353,1301295,-1466108
2020-05-19,82700,1600,4620614,1847585,1115764,731821,1236629,887292,349337,-1081158
2020-05-18,81100,-800,5294177,1104169,1986434,-882265,1438289,1306144,132145,750120
2020-05-15,81900,1300,4168866,1517302,986705,530597,1132077,1459596,-327519,-203078
2020-05-14,80600,-3000,6409652,1241820,2280764,-1038944,522117,3078907,-2556790,3595734
2020-05-13,83600,-2100,5371416,1608873,1924651,-315778,871305,2384108,-1512803,1828581
2020-05-12,85700,1200,3574409,1937239,985583,951656,666995,665667,1328,-952984
2020-05-11,84500,-500,2800047,1081955,1189254,-107299,940175,694921,245254,-137955
2020-05-08,85000,2600,5039635,1838120,1004771,833349,2111561,710971,1400590,-2233939
2020-05-07,82400,0,2660512,1297778,867504,430274,678386,753037,-74651,-355623
2020-05-06,82400,1400,3351424,1468182,905569,562613,892367,1163763,-271396,-291217
2020-05-04,81000,-2700,5280026,1297892,2134271,-836379,1099054,2305150,-1206096,2042475
2020-04-29,83700,300,3750568,1702252,943045,759207,1001097,821275,179822,-939029
2020-04-28,83400,800,3205535,1440615,1051325,389290,857914,298732,559182,-948472
2020-04-27,82600,1200,3235430,1265210,741525,523685,1098580,750847,347733,-871418
2020-04-24,81400,-1200,3193144,454921,1111210,-656289,814232,708148,106084,550205
2020-04-23,82600,-1300,6519481,1242091,2537943,-1295852,1158793,1691049,-532256,1828108
2020-04-22,83900,2600,5335787,2114391,2101517,12874,1535780,1090915,444865,-457739
2020-04-21,81300,-700,5090721,1753655,1782289,-28634,1054879,1893360,-838481,867115
2020-04-20,82000,-2100,5027876,1241916,1611772,-369856,481688,1994301,-1512613,1882469
2020-04-17,84100,2800,6205624,2248099,1289193,958906,1112130,1318932,-206802,-752104
2020-04-16,81300,-1000,4470072,1481148,1344592,136556,1165674,2268289,-1102615,966059
2020-04-14,82300,900,3344109,1422281,825182,597099,876934,887095,-10161,-586938
2020-04-13,81400,-2700,3615318,1018841,2031943,-1013102,290835,692709,-401874,1414976
2020-04-10,84100,-900,3675338,1310519,1932499,-621980,395466,624298,-228832,850812
2020-04-09,85000,500,3555538,1428835,1691904,-263069,746667,803613,-56946,320015
2020-04-08,84500,-1300,3749575,1174029,1281444,-107415,1142892,987043,155849,-48434
2020-04-07,85800,2700,6188649,1995250,1474610,520640,2258713,1640477,618236,-1138876
2020-04-06,83100,3500,5784159,2266060,1107851,1158209,1971387,2072370,-100983,-1057226
2020-04-03,79600,-400,3755301,1201864,1528810,-326946,1064507,693747,370760,-43814
2020-04-02,80000,1600,5394371,1717260,1673136,44124,1181637,1436004,-254367,210243
2020-04-01,78400,-4900,6845675,1465766,3336849,-1871083,1167806,1676629,-508823,2379906
2020-03-31,83300,-400,5333479,1549046,2270154,-721108,1423430,1262404,161026,560082
2020-03-30,83700,400,5270037,1965314,1638139,327175,1254498,1591196,-336698,9523
2020-03-27,83300,2600,8085695,2972927,2792031,180896,2224816,1942679,282137,-463033
2020-03-26,80700,-3800,7895289,2742518,3003975,-261457,1364871,1884017,-519146,780603
2020-03-25,84500,5800,8787217,2565736,2459337,106399,2885298,1940671,944627,-1051026
2020-03-24,78700,9300,7247345,2763029,1995407,767622,1534106,1094230,439876,-1207498
2020-03-23,69400,-5400,8192363,1909220,2411876,-502656,2491761,3063302,-571541,1074197
2020-03-20,74800,5800,8750101,3404238,2402765,1001473,2485274,2832303,-347029,-654444
2020-03-19,69000,-4100,11140367,3283734,2704401,579333,2449817,3391161,-941344,362011
2020-03-18,73100,-7300,7949482,2148189,2521399,-373210,1260532,2625195,-1364663,1737873
2020-03-17,80400,-200,7107436,2254275,2082487,171788,1848820,2357732,-508912,337124
2020-03-16,80600,-1900,5097762,1828874,1748317,80557,1009509,1632523,-623014,542457
2020-03-13,82500,-300,8160758,3043030,2066976,976054,2195518,3105065,-909547,-66507
2020-03-12,82800,-2700,8191818,2730884,2390468,340416,2654397,3192031,-537634,197218
2020-03-11,85500,-3600,5226251,1437953,1859909,-421956,1552944,2023609,-470665,892621
2020-03-10,89100,2200,6579153,2256194,1413468,842726,2374973,3439453,-1064480,221754
2020-03-09,86900,-5700,6196552,1904851,1472243,432608,1398166,3625590,-2227424,1794816
2020-03-06,92600,-2300,3281612,1399686,1209455,190231,861695,1478622,-616927,426696
2020-03-05,94900,600,4028776,1469927,1195302,274625,1487728,1773480,-285752,11127
2020-03-04,94300,1500,4984561,1847783,1315020,532763,1845226,2480947,-635721,102958
2020-03-03,92800,700,5573006,1618377,1656783,-38406,2159029,2636605,-477576,515982
2020-03-02,92100,4200,6382279,2368359,1268745,1099614,2501145,3235908,-734763,-364851
2020-02-28,87900,-4900,8171939,2335919,1263471,1072448,3541317,4851691,-1310374,237926
2020-02-27,92800,-1800,4644449,1428284,1207746,220538,1759768,2334352,-574584,354046
2020-02-26,94600,-3400,6405409,1355549,1162626,192923,2758840,4195946,-1437106,1244183
2020-02-25,98000,-1500,6594059,1554511,1113769,440742,2352992,4366419,-2013427,1572685
2020-02-24,99500,-3500,5550758,960674,1245666,-284992,3504740,3565008,-60268,345260
2020-02-21,103000,-1000,4064719,707632,1357527,-649895,2902611,2253413,649198,697
2020-02-20,104000,500,3093782,1108279,1597769,-489490,1458898,735368,723530,-234040
2020-02-19,103500,1500,2315634,801158,816353,-15195,1105110,994848,110262,-95067
2020-02-18,102000,-3000,2789667,718864,1179642,-460778,1181466,1106352,75114,385664
2020-02-17,105000,500,1190162,517717,478983,38734,289722,338438,-48716,9982
2020-02-14,104500,2500,1893163,648262,562302,85960,754124,453622,300502,-386462
2020-02-13,102000,2000,3519491,1761174,1511507,249667,1256578,511299,745279,-994946
2020-02-12,100000,200,2616573,865350,540339,325011,1217624,1532504,-314880,-10131
2020-02-11,99800,1000,1820578,803691,538930,264761,650692,583266,67426,-332187
2020-02-10,98800,-500,1825648,527699,725836,-198137,751161,809212,-58051,256188
2020-02-07,99300,-1200,1827393,485067,809373,-324306,689315,606324,82991,241315
2020-02-06,100500,2800,2861441,1010328,815905,194423,1226570,567661,658909,-853332
2020-02-05,97700,600,2911995,1052339,1364132,-311793,1164787,864945,299842,11951
2020-02-04,97100,2400,3169743,1235944,1497381,-261437,1150738,913036,237702,23735
2020-02-03,94700,1200,3725535,1861368,1130945,730423,1096954,1661946,-564992,-165431
2020-01-31,93500,-500,4597139,1681065,1225884,455181,1870639,2100097,-229458,-225723
2020-01-30,94000,-3900,3223436,801638,1486341,-684703,819344,1094564,-275220,959923
2020-01-29,97900,1600,2741459,1059115,1188802,-129687,972804,737755,235049,-105362
2020-01-28,96300,-2400,3630362,1414884,1059684,355200,1081603,1545748,-464145,108945
2020-01-23,98700,-2300,2780104,534368,990922,-456554,821477,1425395,-603918,1060472
2020-01-22,101000,1700,2257478,821204,535691,285513,828273,986641,-158368,-127145
2020-01-21,99300,-600,1483291,519267,680109,-160842,476092,439723,36369,124473
2020-01-20,99900,900,1781639,662205,537146,125059,556580,481716,74864,-199923
2020-01-17,99000,-200,2246394,683637,947007,-263370,683090,633092,49998,213372
2020-01-16,99200,1000,2824804,954791,1007269,-52478,766686,1063630,-296944,349422
2020-01-15,98200,-2300,2745625,582926,1473876,-890950,730462,872774,-142312,1033262
2020-01-14,100500,0,2913343,644125,1171075,-526950,1153177,896977,256200,270750
2020-01-13,100500,1600,2242008,758902,880233,-121331,763841,552611,211230,-89899
2020-01-10,98900,-100,2867925,959892,1348145,-388253,1024018,966250,57768,330485
2020-01-09,99000,1600,3586413,1439860,1229647,210213,1149230,1629506,-480276,270063
2020-01-08,97400,3400,7014748,2839121,1868224,970897,2767556,2592685,174871,-1145768
2020-01-07,94000,-300,2489429,920021,814985,105036,947575,1307770,-360195,255159
2020-01-06,94300,-200,2577573,1032662,1107935,-75273,1034985,910682,124303,-49030
2020-01-03,94500,-200,3021380,1315777,1414522,-98745,699565,865300,-165735,264480
2020-01-02,94700,600,2342070,723532,1414456,-690924,1058523,499911,558612,132312
2019-12-30,94100,-1900,1862634,593812,429090,164722,503066,1122058,-618992,454270
2019-12-27,96000,1200,2229470,897435,894328,3107,452410,588100,-135690,132583
2019-12-26,94800,1000,1559839,844689,340272,504417,325224,247987,77237,-581654
2019-12-24,93800,-800,1464093,685586,487629,197957,384016,401569,-17553,-180404
2019-12-23,94600,-400,1720279,696830,609828,87002,585462,484997,100465,-187467
2019-12-20,95000,1400,2791176,588925,804255,-215330,1814360,1110084,704276,-488946
2019-12-19,93600,600,4938375,997288,2126092,-1128804,3005601,1574050,1431551,-302747
2019-12-18,93000,200,3434310,912531,1253857,-341326,1771255,1212748,558507,-217181
2019-12-17,92800,4200,5070618,1480333,1335107,145226,2588443,1370938,1217505,-1362731
2019-12-16,88600,700,2652685,1132122,735381,396741,1113964,976718,137246,-533987
2019-12-13,87900,4500,5831965,1832220,1488666,343554,3334888,922815,2412073,-2755627
2019-12-12,83400,2800,5247299,2816078,2567101,248977,2179369,928772,1250597,-1499574
2019-12-11,80600,-100,2009331,988632,788042,200590,774646,971506,-196860,-3730
2019-12-10,80700,0,1831960,915766,698646,217120,633224,854690,-221466,4346
2019-12-09,80700,100,2290088,806069,687930,118139,1207815,1147153,60662,-178801
2019-12-06,80600,1800,3054204,784527,456500,328027,2043935,1858249,185686,-513713
2019-12-05,78800,1100,3667358,701854,624355,77499,2538309,2365748,172561,-250060
2019-12-04,77700,-1000,6164549,1087154,699551,387603,3629898,4875565,-1245667,858064
2019-12-03,78700,-1800,11657151,1324613,556816,767797,8963023,10683470,-1720447,952650
2019-12-02,80500,-400,1945991,751053,411532,339521,678434,1353901,-675467,335946
2019-11-29,80900,-1900,2139440,702364,665723,36641,666682,1213933,-547251,510610
2019-11-28,82800,100,1413983,549954,528296,21658,689189,469471,219718,-241376
2019-11-27,82700,400,1326621,614021,422516,191505,448892,564679,-115787,-75718
2019-11-26,82300,600,4521090,1653672,449864,1203808,2220837,3203949,-983112,-220696
2019-11-25,81700,0,2602474,1001511,441141,560370,1015309,1805701,-790392,230022
2019-11-22,81700,800,2089767,849815,382943,466872,773064,1272650,-499586,32714
2019-11-21,80900,-1800,3346746,1076125,951675,124450,1027735,2081965,-1054230,929780
2019-11-20,82700,-2600,3315169,1066071,1061272,4799,1223249,1944874,-721625,716826
2019-11-19,85300,-200,2260299,809058,847945,-38887,1192008,977899,214109,-175222
2019-11-18,85500,300,1827506,754995,617407,137588,732376,729098,3278,-140866
2019-11-15,85200,1800,2394138,1173397,530134,643263,975808,680310,295498,-938761
2019-11-14,83400,0,1517137,937817,619046,318771,469660,713798,-244138,-74633
2019-11-13,83400,200,1370289,462091,574714,-112623,791416,482065,309351,-196728
2019-11-12,83200,1900,1555211,617408,498082,119326,752303,524523,227780,-347106
2019-11-11,81300,-1000,2174477,669516,679784,-10268,850746,1283789,-433043,443311
합계,,,984237514,308116680,302447576,5669104,300570576,320099265,-19528689,13859585
