날짜,종가,대비,거래량,기관 매수,기관 매도,기관 순매수,외국인 매수,외국인 매도,외국인 순매수,개인 순매수
2020-11-11,123000,6500,1551092,405513,268314,137199,340370,127502,212868,-350067
2020-11-10,116500,1500,548716,114751,165730,-50979,167005,24232,142773,-91794
2020-11-09,115000,0,470472,146003,136404,9599,37234,39755,-2521,-7078
2020-11-06,115000,-1500,456819,97396,149125,-51729,60549,48762,11787,39942
2020-11-05,116500,2500,536669,134658,108724,25934,102928,32052,70876,-96810
2020-11-04,114000,1500,826560,256460,185736,70724,228934,70088,158846,-229570
2020-11-03,112500,500,487902,116127,103216,12911,44727,35088,9639,-22550
2020-11-02,112000,1500,500486,111471,110168,1303,57467,25272,32195,-33498
2020-10-30,110500,-500,1172993,277802,311481,-33679,142580,140380,2200,31479
2020-10-29,111000,-2000,1151122,229718,419198,-189480,166442,77311,89131,100349
2020-10-28,113000,-2500,1529935,360235,518329,-158094,185692,114128,71564,86530
2020-10-27,115500,-2500,2862367,422337,588436,-166099,597892,470166,127726,38373
2020-10-26,118000,14000,9493136,2344988,1499246,845742,376260,1145223,-768963,-76779
2020-10-23,104000,-500,285334,58075,129642,-71567,81180,29349,51831,19736
2020-10-22,104500,500,216486,65012,75093,-10081,78905,39346,39559,-29478
2020-10-21,104000,1500,208146,61784,76693,-14909,78043,34556,43487,-28578
2020-10-20,102500,-500,281942,63322,119209,-55887,24541,39447,-14906,70793
2020-10-19,103000,1000,401448,151105,170037,-18932,66745,80114,-13369,32301
2020-10-16,102000,-500,344823,104718,212594,-107876,23327,19870,3457,104419
2020-10-15,102500,-1500,272073,76158,80215,-4057,19110,54803,-35693,39750
2020-10-14,104000,-1500,268768,48076,81802,-33726,88355,93386,-5031,38757
2020-10-13,105500,500,263342,79977,115002,-35025,26763,31471,-4708,39733
2020-10-12,105000,500,259281,78951,110669,-31718,19381,40435,-21054,52772
2020-10-08,104500,-500,435015,126068,204858,-78790,76221,105576,-29355,108145
2020-10-07,105000,1000,319146,99735,107358,-7623,77850,133230,-55380,63003
2020-10-06,104000,-1000,272047,64784,98815,-34031,26874,59398,-32524,66555
2020-10-05,105000,0,291328,105841,114006,-8165,43295,98997,-55702,63867
2020-09-29,105000,500,315583,102226,95033,7193,80947,128547,-47600,40407
2020-09-28,104500,2000,201432,78586,78570,16,30469,28082,2387,-2403
2020-09-25,102500,500,287351,80086,126039,-45953,13686,61940,-48254,94207
2020-09-24,102000,-3500,452821,86134,93072,-6938,45847,89263,-43416,50354
2020-09-23,105500,0,335294,76854,116532,-39678,41253,82641,-41388,81066
2020-09-22,105500,-3000,592653,75227,141437,-66210,39548,76852,-37304,103514
2020-09-21,108500,-1000,364751,98179,98865,-686,24152,52064,-27912,28598
2020-09-18,109500,500,312258,91121,107043,-15922,60080,103810,-43730,59652
2020-09-17,109000,-2000,396882,73601,129360,-55759,21172,85915,-64743,120502
2020-09-16,111000,-2500,413185,110419,120599,-10180,14911,111628,-96717,106897
2020-09-15,113500,-500,492371,96310,153584,-57274,108942,74900,34042,23232
2020-09-14,114000,1000,433719,91487,94320,-2833,44972,54720,-9748,12581
2020-09-11,113000,4500,1495263,395769,296809,98960,204798,126009,78789,-177749
2020-09-10,108500,500,619678,144236,285945,-141709,77737,100384,-22647,164356
2020-09-09,108000,-3000,480233,88231,162081,-73850,27694,55141,-27447,101297
2020-09-08,111000,2000,441253,116235,139750,-23515,62813,46887,15926,7589
2020-09-07,109000,1500,373531,61475,125722,-64247,51864,47154,4710,59537
2020-09-04,107500,-2000,534339,85341,239230,-153889,44427,69032,-24605,178494
2020-09-03,109500,1000,453620,104555,132707,-28152,78037,72966,5071,23081
2020-09-02,108500,-2000,605126,81595,186277,-104682,47651,146436,-98785,203467
2020-09-01,110500,2500,782824,195768,230637,-34869,131960,129822,2138,32731
2020-08-31,108000,-4500,1059470,192779,197106,-4327,335964,522591,-186627,190954
2020-08-28,112500,1500,432454,129252,141475,-12223,57133,67484,-10351,22574
2020-08-27,111000,-4000,741838,117368,236347,-118979,107325,126357,-19032,138011
2020-08-26,115000,-3000,583585,184008,248491,-64483,65344,88699,-23355,87838
2020-08-25,118000,1000,589944,248652,237943,10709,76386,109840,-33454,22745
2020-08-24,117000,1500,493821,178422,159731,18691,38157,73470,-35313,16622
2020-08-21,115500,1000,711139,279246,218442,60804,99770,83527,16243,-77047
2020-08-20,114500,-6000,978030,240880,312987,-72107,137321,81296,56025,16082
2020-08-19,120500,4000,823147,228337,210677,17660,107582,91559,16023,-33683
2020-08-18,116500,-7500,1289969,338384,307818,30566,180975,161554,19421,-49987
2020-08-14,124000,-2500,1478454,401570,443827,-42257,112475,150232,-37757,80014
2020-08-13,126500,7000,3201899,918495,557852,360643,216974,343742,-126768,-233875
2020-08-12,119500,9000,1779300,642213,311259,330954,111846,100622,11224,-342178
2020-08-11,110500,1000,741766,224260,198211,26049,51636,81092,-29456,3407
2020-08-10,109500,3000,713622,175886,179159,-3273,91338,44702,46636,-43363
2020-08-07,106500,-2000,427843,108019,173100,-65081,39249,24338,14911,50170
2020-08-06,108500,2500,569838,169847,169157,690,46692,24174,22518,-23208
2020-08-05,106000,1000,399085,166899,173760,-6861,46453,30484,15969,-9108
2020-08-04,105000,1000,316832,82029,107977,-25948,55339,55846,-507,26455
2020-08-03,104000,-2000,496866,107725,261398,-153673,31789,90160,-58371,212044
2020-07-31,106000,-2000,427425,74841,212293,-137452,46776,68453,-21677,159129
2020-07-30,108000,-2500,325177,101965,166936,-64971,21231,28988,-7757,72728
2020-07-29,110500,2000,493854,252109,190008,62101,24218,53898,-29680,-32421
2020-07-28,108500,2000,554410,212773,235960,-23187,87393,34322,53071,-29884
2020-07-27,106500,500,244253,105421,119548,-14127,23760,15361,8399,5728
2020-07-24,106000,-2000,316751,67261,158067,-90806,18276,24909,-6633,97439
2020-07-23,108000,-3000,324123,69792,167032,-97240,28451,46930,-18479,115719
2020-07-22,111000,1000,291068,59424,124298,-64874,54476,37032,17444,47430
2020-07-21,110000,2500,374236,161247,178361,-17114,83205,16755,66450,-49336
2020-07-20,107500,-2500,386459,117142,218274,-101132,26401,21884,4517,96615
2020-07-17,110000,500,233421,75878,127318,-51440,35641,14920,20721,30719
2020-07-16,109500,-1500,281137,100057,125980,-25923,54044,36895,17149,8774
2020-07-15,111000,2000,426006,159330,155079,4251,89713,63490,26223,-30474
2020-07-14,109000,1000,293687,85705,140078,-54373,92622,57980,34642,19731
2020-07-13,108000,3500,368363,93724,124510,-30786,105126,78040,27086,3700
2020-07-10,104500,-2500,370802,84183,167344,-83161,62437,35208,27229,55932
2020-07-09,107000,-1500,529951,176982,272784,-95802,109701,80057,29644,66158
2020-07-08,108500,-2000,447414,118896,209111,-90215,80771,55173,25598,64617
2020-07-07,110500,-2500,469616,116398,220155,-103757,52953,72017,-19064,122821
2020-07-06,113000,1000,394955,122650,128555,-5905,75473,48226,27247,-21342
2020-07-03,112000,-3000,711497,156177,285605,-129428,67534,62382,5152,124276
2020-07-02,115000,2000,306224,124243,118580,5663,93056,43698,49358,-55021
2020-07-01,113000,-3000,443568,156604,175780,-19176,62262,50541,11721,7455
2020-06-30,116000,-500,439721,180863,154460,26403,56156,87270,-31114,4711
2020-06-29,116500,0,687611,248248,273542,-25294,190409,128639,61770,-36476
2020-06-26,116500,500,575645,234982,245382,-10400,119279,170139,-50860,61260
2020-06-25,116000,-2000,639728,220755,273812,-53057,156633,106757,49876,3181
2020-06-24,118000,1500,736235,304282,241402,62880,62106,117804,-55698,-7182
2020-06-23,116500,0,747155,256970,251863,5107,116213,95031,21182,-26289
2020-06-22,116500,-3500,675852,188208,230329,-42121,92140,97275,-5135,47256
2020-06-19,120000,-1500,772021,187762,247091,-59329,261847,152754,109093,-49764
2020-06-18,121500,-500,657356,174930,179709,-4779,170007,92788,77219,-72440
2020-06-17,122000,-2000,1369698,314811,314753,58,228338,265745,-37407,37349
2020-06-16,124000,12000,2696960,687267,496316,190951,324783,320938,3845,-194796
2020-06-15,112000,3500,3554902,928417,678014,250403,332649,379483,-46834,-203569
2020-06-12,108500,-1000,708907,198296,206571,-8275,163297,111775,51522,-43247
2020-06-11,109500,-1500,877197,272103,481349,-209246,194446,59546,134900,74346
2020-06-10,111000,-1500,572891,169882,253341,-83459,66954,43510,23444,60015
2020-06-09,112500,-1000,833872,165300,275193,-109893,110703,56434,54269,55624
2020-06-08,113500,1500,622460,142882,179081,-36199,49422,57705,-8283,44482
2020-06-05,112000,5000,901377,480204,283264,196940,61470,46954,14516,-211456
2020-06-04,107000,0,1047644,482196,349452,132744,153923,116139,37784,-170528
2020-06-03,107000,4000,1128887,448712,255199,193513,140561,66243,74318,-267831
2020-06-02,103000,1000,329090,106500,125668,-19168,24730,13690,11040,8128
2020-06-01,102000,2900,562918,188904,152943,35961,82181,35874,46307,-82268
2020-05-29,99100,-100,537453,141936,174037,-32101,186080,234291,-48211,80312
2020-05-28,99200,-1800,565818,154540,216984,-62444,43494,148909,-105415,167859
2020-05-27,101000,-1500,446462,156281,186907,-30626,50236,111791,-61555,92181
2020-05-26,102500,3000,433229,212149,120990,91159,45578,23079,22499,-113658
2020-05-25,99500,700,259770,107612,118747,-11135,12669,21247,-8578,19713
2020-05-22,98800,-1700,440759,118024,187181,-69157,37700,55529,-17829,86986
2020-05-21,100500,-1000,332713,95361,158427,-63066,54059,53911,148,62918
2020-05-20,101500,-500,252704,90159,125221,-35062,59410,38979,20431,14631
2020-05-19,102000,3800,593063,241034,162629,78405,117468,74695,42773,-121178
2020-05-18,98200,-700,312224,123242,139339,-16097,15214,55579,-40365,56462
2020-05-15,98900,400,390663,164656,156474,8182,72692,125514,-52822,44640
2020-05-14,98500,-1500,517115,164957,182784,-17827,104794,169044,-64250,82077
2020-05-13,100000,0,418968,130881,114919,15962,64713,165309,-100596,84634
2020-05-12,100000,-2500,645194,152290,234542,-82252,139033,232950,-93917,176169
2020-05-11,102500,-3000,461994,135122,170910,-35788,50211,144229,-94018,129806
2020-05-08,105500,2000,510007,268115,161482,106633,41540,41294,246,-106879
2020-05-07,103500,-3000,513122,181778,183621,-1843,48541,149035,-100494,102337
2020-05-06,106500,6600,792744,312375,240354,72021,69088,114245,-45157,-26864
2020-05-04,99900,-6100,625651,180363,213277,-32914,58058,188926,-130868,163782
2020-04-29,106000,3500,589970,293037,138949,154088,87180,66758,20422,-174510
2020-04-28,102500,2800,465534,231920,146310,85610,57517,54947,2570,-88180
2020-04-27,99700,1000,351061,151939,66573,85366,27944,46815,-18871,-66495
2020-04-24,98700,0,695631,234749,236711,-1962,53098,144014,-90916,92878
2020-04-23,98700,1700,561986,233073,128793,104280,59080,74854,-15774,-88506
2020-04-22,97000,3100,474690,192522,162928,29594,100462,82623,17839,-47433
2020-04-21,93900,-1300,571828,225649,176056,49593,105621,100780,4841,-54434
2020-04-20,95200,-700,389522,127242,163255,-36013,55602,48550,7052,28961
2020-04-17,95900,1900,565973,137550,141407,-3857,64215,108654,-44439,48296
2020-04-16,94000,0,538849,166793,145161,21632,152441,235377,-82936,61304
2020-04-14,94000,1800,386674,182807,79078,103729,62122,76793,-14671,-89058
2020-04-13,92200,-2000,556976,206386,150943,55443,63304,122820,-59516,4073
2020-04-10,94200,5300,1392526,411054,311339,99715,108327,138987,-30660,-69055
2020-04-09,88900,1200,539747,275451,165453,109998,66756,176741,-109985,-13
2020-04-08,87700,-1300,437768,144452,209379,-64927,90110,72404,17706,47221
2020-04-07,89000,1400,517486,142604,161244,-18640,84947,92568,-7621,26261
2020-04-06,87600,2800,352050,160016,57486,102530,58659,86401,-27742,-74788
2020-04-03,84800,-800,428005,104937,149217,-44280,119445,111864,7581,36699
2020-04-02,85600,700,433092,152733,118194,34539,107386,110203,-2817,-31722
2020-04-01,84900,-4700,483939,85558,188490,-102932,104146,165280,-61134,164066
2020-03-31,89600,1300,454321,145334,148385,-3051,123729,96428,27301,-24250
2020-03-30,88300,-1500,444420,146792,151422,-4630,56221,57499,-1278,5908
2020-03-27,89800,2500,590727,176264,151146,25118,230758,132579,98179,-123297
2020-03-26,87300,-2700,617602,137503,225272,-87769,198920,160596,38324,49445
2020-03-25,90000,6300,765916,164245,241673,-77428,243201,128652,114549,-37121
2020-03-24,83700,9200,684986,235603,190143,45460,169084,121819,47265,-92725
2020-03-23,74500,-6000,501217,134581,190150,-55569,94714,116480,-21766,77335
2020-03-20,80500,4100,690277,226539,187785,38754,135034,191890,-56856,18102
2020-03-19,76400,-6700,896134,284899,222043,62856,313547,215776,97771,-160627
2020-03-18,83100,-5100,517037,105513,185874,-80361,187987,174440,13547,66814
2020-03-17,88200,-1500,577410,201915,170379,31536,182511,163089,19422,-50958
2020-03-16,89700,-4000,472425,126862,182851,-55989,124158,116300,7858,48131
2020-03-13,93700,-3600,1242161,355351,260926,94425,500464,300496,199968,-294393
2020-03-12,97300,-4200,871598,396986,389353,7633,194131,257385,-63254,55621
2020-03-11,101500,-2500,380742,142618,187854,-45236,135503,74336,61167,-15931
2020-03-10,104000,500,501439,229508,194010,35498,138086,157392,-19306,-16192
2020-03-09,103500,-4500,502867,165685,197109,-31424,132316,167013,-34697,66121
2020-03-06,108000,-3000,318195,140677,185977,-45300,52800,45141,7659,37641
2020-03-05,111000,2000,392545,193650,241846,-48196,96698,46661,50037,-1841
2020-03-04,109000,2500,353320,181613,142513,39100,99484,92191,7293,-46393
2020-03-03,106500,0,407337,98753,205747,-106994,169296,103609,65687,41307
2020-03-02,106500,1000,418061,138953,235136,-96183,147579,53318,94261,1922
2020-02-28,105500,-3500,650896,244772,296674,-51902,238192,141106,97086,-45184
2020-02-27,109000,-1500,657663,223162,365044,-141882,141854,120419,21435,120447
2020-02-26,110500,-1500,331040,145622,162326,-16704,100402,89063,11339,5365
2020-02-25,112000,2500,402750,157117,165781,-8664,126738,93098,33640,-24976
2020-02-24,109500,-4000,445637,169717,158730,10987,168742,77157,91585,-102572
2020-02-21,113500,-2000,299243,92659,142070,-49411,108602,42934,65668,-16257
2020-02-20,115500,-2000,286186,75325,176298,-100973,82111,35535,46576,54397
2020-02-19,117500,500,245852,83183,123601,-40418,81354,22026,59328,-18910
2020-02-18,117000,-2500,394843,89148,208712,-119564,103849,75720,28129,91435
2020-02-17,119500,0,210755,73575,85264,-11689,29386,38142,-8756,20445
2020-02-14,119500,1000,310446,93491,146544,-53053,91099,45862,45237,7816
2020-02-13,118500,-1000,443917,146649,220740,-74091,39759,56440,-16681,90772
2020-02-12,119500,500,325990,127719,109321,18398,51227,78780,-27553,9155
2020-02-11,119000,3000,543327,215824,181573,34251,95379,72011,23368,-57619
2020-02-10,116000,1000,297490,116325,116756,-431,53915,72862,-18947,19378
2020-02-07,115000,-500,358446,111796,181753,-69957,100886,53385,47501,22456
2020-02-06,115500,5000,608944,293450,204152,89298,82047,68146,13901,-103199
2020-02-05,110500,-500,405448,142128,218912,-76784,164621,95373,69248,7536
2020-02-04,111000,3500,387111,169720,231340,-61620,94593,33105,61488,132
2020-02-03,107500,-1000,379093,192986,197449,-4463,67461,56643,10818,-6355
2020-01-31,108500,-2000,391016,190868,191019,-151,99835,76376,23459,-23308
2020-01-30,110500,-3000,448272,175876,273462,-97586,93411,38196,55215,42371
2020-01-29,113500,1500,384304,151624,194573,-42949,122941,47816,75125,-32176
2020-01-28,112000,-5000,706005,284538,255344,29194,84622,117103,-32481,3287
2020-01-23,117000,5000,1290170,716920,516150,200770,159170,142860,16310,-217080
2020-01-22,112000,2000,285391,165403,100918,64485,17252,65782,-48530,-15955
2020-01-21,110000,-2000,248677,122586,115792,6794,16039,50414,-34375,27581
2020-01-20,112000,4500,544608,357481,195476,162005,59564,46401,13163,-175168
2020-01-17,107500,-500,181114,80123,97701,-17578,21017,31696,-10679,28257
2020-01-16,108000,1000,200395,104652,106137,-1485,39230,13273,25957,-24472
2020-01-15,107000,0,199124,54932,123490,-68558,62497,23186,39311,29247
2020-01-14,107000,-2000,343008,110279,218999,-108720,54477,41135,13342,95378
2020-01-13,109000,2000,336316,192662,132496,60166,42779,51523,-8744,-51422
2020-01-10,107000,500,267976,144460,120398,24062,49999,76774,-26775,2713
2020-01-09,106500,1500,446040,127256,317825,-190569,55665,58002,-2337,192906
2020-01-08,105000,-3000,409091,171743,194337,-22594,46899,77286,-30387,52981
2020-01-07,108000,2000,200467,114522,83528,30994,34199,21877,12322,-43316
2020-01-06,106000,-1500,236334,110795,111672,-877,51576,9442,42134,-41257
2020-01-03,107500,0,253791,100123,142492,-42369,57957,18357,39600,2769
2020-01-02,107500,-1000,232765,81096,143951,-62855,48313,15748,32565,30290
2019-12-30,108500,-500,236635,113741,47223,66518,29724,90382,-60658,-5860
2019-12-27,109000,2500,393278,182864,121223,61641,76019,37742,38277,-99918
2019-12-26,106500,-1500,449185,215223,44881,170342,18050,17793,257,-170599
2019-12-24,108000,-1000,277714,151227,32009,119218,15118,28247,-13129,-106089
2019-12-23,109000,500,303980,215194,38499,176695,22691,47220,-24529,-152166
2019-12-20,108500,1000,314911,148344,36211,112133,119809,130088,-10279,-101854
2019-12-19,107500,4500,494970,241596,124575,117021,150470,30631,119839,-236860
2019-12-18,103000,0,184459,68498,54454,14044,69426,41886,27540,-41584
2019-12-17,103000,-1000,317989,149559,61477,88082,77458,116946,-39488,-48594
2019-12-16,104000,0,179817,109063,52153,56910,22924,55180,-32256,-24654
2019-12-13,104000,1500,233850,112566,70513,42053,59569,16241,43328,-85381
2019-12-12,102500,1500,444609,322277,276629,45648,98887,27559,71328,-116976
2019-12-11,101000,500,137557,87932,61140,26792,36452,15720,20732,-47524
2019-12-10,100500,700,192039,87690,74855,12835,57571,19251,38320,-51155
2019-12-09,99800,-1200,176408,68518,99520,-31002,36351,25864,10487,20515
2019-12-06,101000,500,207075,99653,79846,19807,46828,60858,-14030,-5777
2019-12-05,100500,-2000,268482,141996,71532,70464,27268,104093,-76825,6361
2019-12-04,102500,1000,285419,174811,69451,105360,65900,140043,-74143,-31217
2019-12-03,101500,1000,204605,136851,74839,62012,37360,66411,-29051,-32961
2019-12-02,100500,1600,244030,168335,58707,109628,47347,96844,-49497,-60131
2019-11-29,98900,-2600,301534,105325,115514,-10189,68038,92382,-24344,34533
2019-11-28,101500,0,148563,48546,60718,-12172,40739,21499,19240,-7068
2019-11-27,101500,-500,185696,75534,56105,19429,63648,71077,-7429,-12000
2019-11-26,102000,-2000,483971,164178,127267,36911,202175,274046,-71871,34960
2019-11-25,104000,2500,208912,103106,44565,58541,62077,68166,-6089,-52452
2019-11-22,101500,500,182751,92445,42760,49685,60993,63844,-2851,-46834
2019-11-21,101000,-1500,320446,139480,99936,39544,63215,69460,-6245,-33299
2019-11-20,102500,-500,196959,80262,72614,7648,45709,43591,2118,-9766
2019-11-19,103000,-1000,204642,74801,79162,-4361,55818,57956,-2138,6499
2019-11-18,104000,0,234521,75920,82917,-6997,20779,72698,-51919,58916
2019-11-15,104000,1500,267000,123094,35013,88081,11834,92860,-81026,-7055
2019-11-14,102500,2000,315761,237548,207273,30275,48207,38814,9393,-39668
2019-11-13,100500,-1500,175104,70606,94044,-23438,29947,36009,-6062,29500
2019-11-12,102000,0,189839,79039,83510,-4471,45493,46100,-607,5078
2019-11-11,102000,-500,225387,79770,89292,-9522,81952,23518,58434,-48912
합계,,,141234777,45233137,45433431,-200294,22935811,22846703,89108,111186
