,날짜,종가,대비,거래량,기관 매수,기관 매도,기관 순매수,외국인 매수,외국인 매도,외국인 순매수,개인 순매수,개인 매수,개인 매도,개인매수비율(%),개인매수비율증가(%p),개인매도비율(%),개인매도비율증가(%p)
0,2020-11-11,47250.0,2550.0,3407691,884544,854532,30012,1762715,522588,1240127,-1270139,760432,2030571,22.315168834263435,,59.587885169165865,
1,2020-11-10,44700.0,1750.0,2913985,1396830,796542,600288,844863,578974,265889,-866177,672292,1538469,23.071223770884203,0.7560549366207674,52.79605076896415,-6.791834400201715
2,2020-11-09,42950.0,300.0,1350713,629356,326852,302504,342785,446503,-103718,-198786,378572,577358,28.027567662412373,4.956343891528171,42.744683733702125,-10.051367035262025
3,2020-11-06,42650.0,-250.0,1403645,462238,485593,-23355,487379,458247,29132,-5777,454028,459805,32.34635538188075,4.318787719468375,32.75792668374126,-9.986757049960865
4,2020-11-05,42900.0,1350.0,2077254,730164,696842,33322,811022,526355,284667,-317989,536068,854057,25.806569634719683,-6.539785747161066,41.11471201884796,8.3567853351067
5,2020-11-04,41550.0,-1100.0,2640754,831033,1423294,-592261,616188,564361,51827,540434,1193533,653099,45.196674889065775,19.390105254346093,24.73153500856195,-16.383177010286012
6,2020-11-03,42650.0,650.0,1535972,561080,313972,247108,591781,539127,52654,-299762,383111,682873,24.94257707822799,-20.254097810837784,44.45868804900089,19.727153040438942
7,2020-11-02,42000.0,1900.0,1789683,866684,497246,369438,574651,559173,15478,-384916,348348,733264,19.464229140020887,-5.478347938207104,40.97172516026581,-3.4869628887350785
8,2020-10-30,40100.0,-900.0,1936145,458729,543965,-85236,558237,842995,-284758,369994,919179,549185,47.474698434259835,28.01046929423895,28.36486936670549,-12.606855793560321
9,2020-10-29,41000.0,-1050.0,1903504,368936,675072,-306136,556345,791516,-235171,541307,978223,436916,51.39064588254083,3.9159474482809955,22.953248325193957,-5.411621041511534
10,2020-10-28,42050.0,300.0,1186091,376885,506374,-129489,351796,276088,75708,53781,457410,403629,38.564494629838684,-12.826151252702147,34.03018824019405,11.076939915000093
11,2020-10-27,41750.0,-650.0,2088168,567027,747669,-180642,910923,761456,149467,31175,610218,579043,29.222648752399234,-9.34184587743945,27.72971331808552,-6.300474922108531
12,2020-10-26,42400.0,150.0,2149785,894045,683473,210572,635927,690134,-54207,-156365,619813,776178,28.831394767383717,-0.391253985015517,36.104912816863084,8.375199498777565
13,2020-10-23,42250.0,350.0,2912806,1161290,792735,368555,819297,647770,171527,-540082,932219,1472301,32.00415681648555,3.1727620491018307,50.54579673345908,14.440883916595993
14,2020-10-22,41900.0,450.0,2432512,931314,710683,220631,778912,517339,261573,-482204,722286,1204490,29.693008708692908,-2.31114810779264,49.51630248894969,-1.0294942445093866
15,2020-10-21,41450.0,700.0,2378411,1188187,490004,698183,610759,841352,-230593,-467590,579465,1047055,24.363535150148564,-5.329473558544343,44.02329958951586,-5.493002899433833
16,2020-10-20,40750.0,50.0,1531385,561009,510248,50761,229510,506632,-277122,226361,740866,514505,48.37882047950058,24.015285329352018,33.597364477254246,-10.425935112261612
17,2020-10-19,40700.0,1300.0,2737109,1225562,559519,666043,736966,403916,333050,-999093,774581,1773674,28.299238356967148,-20.079582122533434,64.80099988710715,31.203635409852907
18,2020-10-16,39400.0,350.0,1459454,441637,400370,41267,527545,403398,124147,-165414,490272,655686,33.592836773204226,5.293598416237078,44.926801392849654,-19.8741984942575
19,2020-10-15,39050.0,300.0,1506358,448331,400359,47972,512032,736699,-224667,176695,545995,369300,36.24603181979317,2.653195046588941,24.51608448987558,-20.410716902974073
20,2020-10-14,38750.0,-1450.0,2599729,562347,812844,-250497,543081,1224800,-681719,932216,1494301,562085,57.47910647609808,21.233074656304915,21.620907409964655,-2.895177079910926
21,2020-10-13,40200.0,-550.0,1829831,780327,699391,80936,509128,580313,-71185,-9751,540376,550127,29.531470392620957,-27.947636083477125,30.064361134990065,8.44345372502541
22,2020-10-12,40750.0,900.0,2172164,1095048,604682,490366,686256,616436,69820,-560186,390860,951046,17.994037282636118,-11.537433109984839,43.78334232590173,13.718981190911663
23,2020-10-08,39850.0,-50.0,1601362,468032,686826,-218794,643101,399324,243777,-24983,490229,515212,30.61325296841064,12.619215685774524,32.17336242523552,-11.609979900666211
24,2020-10-07,39900.0,900.0,1673843,843608,400291,443317,480736,487322,-6586,-436731,349499,786230,20.880034746388997,-9.733218222021645,46.97154990043869,14.798187475203171
25,2020-10-06,39000.0,-50.0,1696809,583113,539609,43504,378523,440333,-61810,18306,735173,716867,43.32679753584522,22.446762789456226,42.247948944165195,-4.7236009562734935
26,2020-10-05,39050.0,1500.0,2800737,1076419,435049,641370,1197017,563879,633138,-1274508,527301,1801809,18.827222977380597,-24.499574558464627,64.33338796181148,22.085439017646287
27,2020-09-29,37550.0,-650.0,1950270,473026,361782,111244,569395,1176213,-606818,495574,907849,412275,46.549913601706436,27.72269062432584,21.13938070113369,-43.19400726067779
28,2020-09-28,38200.0,0.0,988581,341778,221293,120485,334194,355103,-20909,-99576,312609,412185,31.62199152118036,-14.927922080526077,41.69461076027154,20.55523005913785
29,2020-09-25,38200.0,1000.0,1918648,557147,524981,32166,1001054,328634,672420,-704586,360447,1065033,18.78651008418428,-12.83548143699608,55.509556729530374,13.814945969258837
30,2020-09-24,37200.0,-350.0,1637655,503178,490423,12755,614361,686446,-72085,59330,520116,460786,31.759802888886853,12.973292804702574,28.136939709523677,-27.372617020006697
31,2020-09-23,37550.0,100.0,1596892,545052,500634,44418,595408,519069,76339,-120757,456432,577189,28.5825215481072,-3.177281340779654,36.14452323638668,8.007583526863005
32,2020-09-22,37450.0,-200.0,1538136,335779,594893,-259114,771819,371771,400048,-140934,430538,571472,27.990892872931912,-0.5916286751752864,37.15354168942148,1.0090184530347983
33,2020-09-21,37650.0,-100.0,1185153,371382,396454,-25072,386677,436098,-49421,74493,427094,352601,36.03703488072848,8.046142007796565,29.751517314642072,-7.402024374779408
34,2020-09-18,37750.0,-200.0,1158360,372444,323077,49367,417217,601473,-184256,134889,368699,233810,31.829396733312613,-4.207638147415864,20.18457129044511,-9.566946024196962
35,2020-09-17,37950.0,50.0,1128497,338966,497737,-158771,299255,293358,5897,152874,490276,337402,43.44504238823851,11.615645654925899,29.898351524195455,9.713780233750345
36,2020-09-16,37900.0,-450.0,1243553,256985,496734,-239749,300340,430480,-130140,369889,686228,316339,55.182851072692515,11.737808684454002,25.438320682753368,-4.460030841442087
37,2020-09-15,38350.0,50.0,1494998,383488,579628,-196140,428464,315204,113260,82880,683046,600166,45.688756774256554,-9.49409429843596,40.144936648744675,14.706615965991308
38,2020-09-14,38300.0,1150.0,1794696,443529,379664,63865,916755,253050,663705,-727570,434412,1161982,24.205325024405248,-21.483431749851306,64.74533848629517,24.600401837550493
39,2020-09-11,37150.0,-400.0,1453185,310274,376035,-65761,266457,746059,-479602,545363,876454,331091,60.3126236508084,36.10729862640315,22.78381623812522,-41.96152224816995
40,2020-09-10,37550.0,50.0,1649298,623511,801952,-178441,529369,481487,47882,130559,496418,365859,30.098745041829915,-30.213878608978483,22.1827104622694,-0.6011057758558174
41,2020-09-09,37500.0,-300.0,1325683,350502,553291,-202789,360339,332215,28124,174665,614842,440177,46.37926261406384,16.280517572233926,33.203790046338376,11.021079584068975
42,2020-09-08,37800.0,-450.0,1861721,482096,768346,-286250,257366,323411,-66045,352295,1122259,769964,60.280729497062126,13.901466882998285,41.35764703733803,8.153856990999657
43,2020-09-07,38250.0,1300.0,2246561,631904,596131,35773,741257,364410,376847,-412620,873400,1286020,38.87719941724262,-21.403530079819504,57.24393862441305,15.886291587075014
44,2020-09-04,36950.0,-450.0,1622570,367056,963310,-596254,277728,205315,72413,523841,977786,453945,60.26156036411372,21.384360946871098,27.97691316861522,-29.267025455797828
45,2020-09-03,37400.0,-300.0,1493906,425088,600237,-175149,370514,407005,-36491,211640,698304,486664,46.743503272628935,-13.518057091484785,32.57661459288603,4.599701424270812
46,2020-09-02,37700.0,300.0,1363294,475636,460768,14868,478399,423220,55179,-70047,409259,479306,30.01986365376801,-16.723639618860926,35.15793365187553,2.5813190589895
47,2020-09-01,37400.0,550.0,1747651,559502,622765,-63263,740696,530155,210541,-147278,447453,594731,25.60310954532684,-4.416754108441168,34.03030696632222,-1.1276266855533095
48,2020-08-31,36850.0,-1150.0,3473865,808139,965458,-157319,1055119,1880789,-825670,982989,1610607,627618,46.363546079079065,20.760436533752223,18.06685061163862,-15.9634563546836
49,2020-08-28,38000.0,1050.0,3094558,1047289,662963,384326,1054727,602037,452690,-837016,992542,1829558,32.07378889004504,-14.289757189034027,59.12178734410536,41.054936732466736
50,2020-08-27,36950.0,-150.0,1518005,259737,631948,-372211,475567,212885,262682,109529,782701,673172,51.56116086574155,19.48737197569651,44.3458354880254,-14.775951856079956
51,2020-08-26,37100.0,-850.0,2118673,385859,961942,-576083,387614,716083,-328469,904552,1345200,440648,63.49257294542385,11.931412079682303,20.798301578393648,-23.547533909631753
52,2020-08-25,37950.0,1000.0,1577837,599470,697899,-98429,210291,146421,63870,34559,768076,733517,48.67904606115841,-14.813526884265443,46.4887691187366,25.69046754034295
53,2020-08-24,36950.0,200.0,1254718,397359,580454,-183095,368494,228616,139878,43217,488865,445648,38.9621412939003,-9.716904767258107,35.51778168480886,-10.97098743392774
54,2020-08-21,36750.0,300.0,1682480,503093,927495,-424402,182315,168128,14187,410215,997072,586857,59.262041747895964,20.29990045399566,34.880474062098806,-0.637307622710054
55,2020-08-20,36450.0,-1550.0,2376891,578589,1077270,-498681,368072,266066,102006,396675,1430230,1033555,60.172300707100156,0.9102589592041923,43.48348325606854,8.603009193969733
56,2020-08-19,38000.0,-150.0,1283988,456569,478609,-22040,120492,231110,-110618,132658,706927,574269,55.05713449035349,-5.115166216746665,44.725417994560694,1.241934738492155
57,2020-08-18,38150.0,-1650.0,2848865,813687,814926,-1239,942887,543420,399467,-398228,1092291,1490519,38.341269242312286,-16.715865248041204,52.3197483910259,7.594330396465203
58,2020-08-14,39800.0,-1700.0,2859261,692770,673386,19384,666047,962998,-296951,277567,1500444,1222877,52.47663644557108,14.135367203258795,42.76898821059008,-9.550760180435816
59,2020-08-13,41500.0,1150.0,4253152,971247,1152137,-180890,1873734,734848,1138886,-957996,1408171,2366167,33.10888019050342,-19.36775625506766,55.633257405331385,12.864269194741304
60,2020-08-12,40350.0,1550.0,5024954,1401157,1418190,-17033,1097136,655814,441322,-424289,2526661,2950950,50.282271240691955,17.173391050188535,58.72591072475489,3.092653319423505
61,2020-08-11,38800.0,1650.0,4668361,1498803,1131948,366855,1194269,484740,709529,-1076384,1975289,3051673,42.3122590562298,-7.970012184462156,65.36925914683975,6.643348422084863
62,2020-08-10,37150.0,1000.0,2482203,773819,573073,200746,431173,162498,268675,-469421,1277211,1746632,51.45473597445495,9.14247691822515,70.36620292538524,4.996943778545486
63,2020-08-07,36150.0,-400.0,1831365,328703,749946,-421243,646771,493773,152998,268245,855891,587646,46.73514018232302,-4.719595792131926,32.087868884684376,-38.27833404070086
64,2020-08-06,36550.0,1050.0,3369375,1073137,877262,195875,1079363,423475,655888,-851763,1216875,2068638,36.11574846967168,-10.619391712651343,61.39530328324986,29.307434398565483
65,2020-08-05,35500.0,0.0,1272456,300007,565008,-265001,391110,245747,145363,119638,581339,461701,45.68637343845288,9.570624968781203,36.28424086962536,-25.111062413624502
66,2020-08-04,35500.0,250.0,1345023,459722,557018,-97296,351662,202492,149170,-51874,533639,585513,39.67508362310533,-6.011289815347553,43.53182064544621,7.247579775820853
67,2020-08-03,35250.0,0.0,1056472,296841,489843,-193002,234806,240117,-5311,198313,524825,326512,49.677132948151964,10.002049325046634,30.90588297654836,-12.625937668897851
68,2020-07-31,35250.0,-700.0,1893355,312510,583030,-270520,604269,939336,-335067,605587,976576,370989,51.57912805575289,1.901995107600925,19.59426520647211,-11.31161777007625
69,2020-07-30,35950.0,-250.0,1773544,513409,596210,-82801,248792,567523,-318731,401532,1011343,609811,57.02384603934269,5.444717983589804,34.38375365933972,14.789488452867609
70,2020-07-29,36200.0,500.0,1543911,579216,601192,-21976,441382,289009,152373,-130397,523313,653710,33.89528282394516,-23.128563215397534,42.341171220361794,7.957417561022076
71,2020-07-28,35700.0,250.0,1739731,521492,926484,-404992,499729,280556,219173,185819,718510,532691,41.30006305572528,7.404780231780123,30.61915893893941,-11.722012281422383
72,2020-07-27,35450.0,50.0,1154928,456135,437543,18592,308583,244550,64033,-82625,390210,472835,33.78652175720045,-7.513541298524835,40.94064738234764,10.321488443408231
73,2020-07-24,35400.0,-450.0,1583429,372306,547222,-174916,395852,494869,-99017,273933,815271,541338,51.487689059629446,17.701167302429,34.18770276406457,-6.752944618283074
74,2020-07-23,35850.0,-350.0,1829737,428538,863971,-435433,429647,495861,-66214,501647,971552,469905,53.09790423432439,1.6102151746949431,25.681559699563376,-8.506143064501192
75,2020-07-22,36200.0,-500.0,3174680,905649,1179185,-273536,756909,748222,8687,264849,1512122,1247273,47.630690337293835,-5.467213897030554,39.288148726800806,13.60658902723743
76,2020-07-21,36700.0,-200.0,2060791,887356,701654,185702,183633,514777,-331144,145442,989802,844360,48.030198113248744,0.39950777595490905,40.97261682528699,1.6844680984861853
77,2020-07-20,36900.0,1250.0,2428100,1085562,540760,544802,565637,364235,201402,-746204,776901,1523105,31.996252213665006,-16.03394589958374,62.72826489848029,21.7556480731933
78,2020-07-17,35650.0,-300.0,1595399,465253,533028,-67775,429602,465984,-36382,104157,700544,596387,43.91026946864076,11.914017254975757,37.38168320275994,-25.346581695720353
79,2020-07-16,35950.0,300.0,1721130,671699,513444,158255,286432,392043,-105611,-52644,762999,815643,44.331282355196876,0.42101288655611313,47.38997054260864,10.0082873398487
80,2020-07-15,35650.0,550.0,2786466,1341544,802239,539305,510716,719013,-208297,-331008,934206,1265214,33.5265529886243,-10.804729366572573,45.40568591183241,-1.98428463077623
81,2020-07-14,35100.0,-250.0,973577,380318,519179,-138861,257257,212619,44638,94223,336002,241779,34.51211357704629,0.9855605884219898,24.834091191554446,-20.57159472027796
82,2020-07-13,35350.0,1400.0,1765624,646839,445600,201239,620590,292406,328184,-529423,498195,1027618,28.216369963253783,-6.29574361379251,58.20140641495585,33.367315223401405
83,2020-07-10,33950.0,-750.0,1914633,461756,813196,-351440,617241,702471,-85230,436670,835636,398966,43.64470893377477,15.42833897052099,20.83772712577293,-37.36367928918292
84,2020-07-09,34700.0,-350.0,1962294,720297,916814,-196517,807211,691029,116182,80335,434786,354451,22.157026419078896,-21.487682514695877,18.063093501789233,-2.7746336239836964
85,2020-07-08,35050.0,-750.0,1613501,491402,589873,-98471,638644,719060,-80416,178887,483455,304568,29.963105073997475,7.806078654918579,18.876220095308277,0.8131265935190441
86,2020-07-07,35800.0,50.0,1837584,679263,707896,-28633,669455,412189,257266,-228633,488866,717499,26.603736210154207,-3.359368863843269,39.0457796759223,20.16955958061402
87,2020-07-06,35750.0,950.0,2081699,566722,460993,105729,1057296,623327,433969,-539698,457681,997379,21.98593552670199,-4.6178006834522165,47.91177783147324,8.86599815555094
88,2020-07-03,34800.0,350.0,1032764,410562,358389,52173,378698,239696,139002,-191175,243504,434679,23.57789388475973,1.5919583580577417,42.088899303229006,-5.822878528244232
89,2020-07-02,34450.0,50.0,1944623,457446,409510,47936,1138009,1198827,-60818,12882,349168,336286,17.955562594909143,-5.622331289850589,17.29312056887119,-24.795778734357818
90,2020-07-01,34400.0,450.0,1797943,599190,561804,37386,605122,343540,261582,-298968,593631,892599,33.01723135827999,15.06166876337085,49.6455671842767,32.35244661540551
91,2020-06-30,33950.0,50.0,2139717,427048,773355,-346307,834441,834781,-340,346647,878228,531581,41.04411938588141,8.026888027601416,24.8435190261142,-24.8020481581625
92,2020-06-29,33900.0,-900.0,1716673,401004,730236,-329232,430254,611571,-181317,510549,885415,374866,51.577382530045035,10.533263144163627,21.83677380607722,-3.006745220036983
93,2020-06-26,34800.0,1050.0,1889305,752811,641950,110861,616377,296895,319482,-430343,520117,950460,27.52954128634604,-24.047841243698997,50.307388166548016,28.470614360470798
94,2020-06-25,33750.0,-1150.0,1908667,472880,845933,-373053,308779,580483,-271704,644757,1127008,482251,59.0468635964262,31.51732231008016,25.2663770055227,-25.041011161025317
95,2020-06-24,34900.0,200.0,1373398,565235,417733,147502,314171,464649,-150478,2976,493992,491016,35.96859759516178,-23.078266001264417,35.751908769344354,10.485531763821655
96,2020-06-23,34700.0,-150.0,1858916,808877,838297,-29420,390784,370618,20166,9254,659255,650001,35.46448575406312,-0.5041118410986627,34.96666874673197,-0.7852400226123848
97,2020-06-22,34850.0,-1150.0,1689143,500283,588224,-87941,152267,572906,-420639,508580,1036593,528013,61.36798364614482,25.903497892081703,31.259224352230685,-3.707444394501284
98,2020-06-19,36000.0,750.0,3560935,928707,946809,-18102,1831063,1474886,356177,-338075,801165,1139240,22.498725756016327,-38.869257890128495,31.992721012880043,0.733496660649358
99,2020-06-18,35250.0,250.0,2556965,1024322,932413,91909,913054,606249,306805,-398714,619589,1018303,24.231422800077436,1.7326970440611085,39.8246749564425,7.831953943562457
100,2020-06-17,35000.0,-700.0,3829768,1172865,1288384,-115519,797307,1484054,-686747,802266,1859596,1057330,48.55636163861623,24.324938838538795,27.60819976562549,-12.216475190817011
101,2020-06-16,35700.0,2450.0,2255201,955225,637001,318224,484112,303676,180436,-498660,815864,1314524,36.17699708363024,-12.37936455498599,58.28855166346592,30.680351897840428
102,2020-06-15,33250.0,-1400.0,3388071,872134,1251281,-379147,1017677,760736,256941,122206,1498260,1376054,44.22162345476231,8.044626371132068,40.6146742497427,-17.67387741372322
103,2020-06-12,34650.0,-1700.0,3806558,884842,1459344,-574502,681938,1031222,-349284,923786,2239778,1315992,58.83998089612715,14.618357441364843,34.57170493658575,-6.042969313156945
104,2020-06-11,36350.0,-1200.0,4278133,812422,1607383,-794961,1059087,1107697,-48610,843571,2406624,1563053,56.25407157748485,-2.585909318642301,36.53586739823189,1.96416246164614
105,2020-06-10,37550.0,-950.0,2748853,525963,913931,-387968,1069694,1090471,-20777,408745,1153196,744451,41.951897755172794,-14.302173822312056,27.082241211152436,-9.453626187079458
106,2020-06-09,38500.0,300.0,2520713,640080,758785,-118705,936281,521590,414691,-295986,944352,1240338,37.463685869831274,-4.488211885341521,49.20583977628552,22.123598565133086
107,2020-06-08,38200.0,150.0,2840784,640005,926164,-286159,841073,629687,211386,74773,1359706,1284933,47.86375873702471,10.400072867193437,45.23163323927479,-3.97420653701073
108,2020-06-05,38050.0,1050.0,2412060,894293,517716,376577,491249,285306,205943,-582520,1026518,1609038,42.55773073638301,-5.306028000641703,66.70804208850527,21.476408849230474
109,2020-06-04,37000.0,-1600.0,6220789,1416464,1501776,-85312,1078932,2335772,-1256840,1342152,3725393,2383241,59.886181640303185,17.328450903920178,38.31091200810701,-28.397130080398256
110,2020-06-03,38600.0,2350.0,5291169,1954451,1095776,858675,961408,1023484,-62076,-796599,2375310,3171909,44.89196999755631,-14.994211642746876,59.94722527290283,21.636313264795817
111,2020-06-02,36250.0,1650.0,3992096,1777752,727194,1050558,464677,659104,-194427,-856131,1749667,2605798,43.82827968064896,-1.0636903169073477,65.27393128822553,5.326706015322699
112,2020-06-01,34600.0,600.0,2643715,737834,468921,268913,772695,664058,108637,-377550,1133186,1510736,42.863394881823496,-0.9648847988254659,57.14443500906867,-8.129496279156854
113,2020-05-29,34000.0,-200.0,4473646,839257,576293,262964,2266272,2463716,-197444,-65520,1368117,1433637,30.581700027226116,-12.28169485459738,32.04627724232091,-25.09815776674776
114,2020-05-28,34200.0,1100.0,6324651,2109554,1310788,798766,1592309,740452,851857,-1650623,2622788,4273411,41.469292139597904,10.887592112371788,67.56753850923948,35.52126126691857
115,2020-05-27,33100.0,500.0,4885554,1440579,583068,857511,1747084,1722238,24846,-882357,1697891,2580248,34.75329512272303,-6.715997016874873,52.813826231375195,-14.753712277864288
116,2020-05-26,32600.0,1250.0,3224756,853170,389928,463242,1055609,365472,690137,-1153379,1315977,2469356,40.80857590465759,6.055280781934556,76.57497187384101,23.761145642465813
117,2020-05-25,31350.0,250.0,1387582,375086,336952,38134,395391,492049,-96658,58524,617105,558581,44.47340769770724,3.6648317930496503,40.25571101383558,-36.31926086000543
118,2020-05-22,31100.0,-900.0,2073547,271547,378275,-106728,356572,1032051,-675479,782207,1445428,663221,69.70799311517897,25.234585417471727,31.984854936975143,-8.270856076860436
119,2020-05-21,32000.0,-50.0,1690229,257904,546002,-288098,624476,542125,82351,205747,807849,602102,47.79523957996224,-21.912753535216723,35.62251032256576,3.637655385590616
120,2020-05-20,32050.0,100.0,1529458,255133,377339,-122206,674989,509077,165912,-43706,599336,643042,39.186169218115175,-8.609070361847067,42.04378283025751,6.421272507691754
121,2020-05-19,31950.0,950.0,3318803,995758,359710,636048,813429,941749,-128320,-507728,1509616,2017344,45.486761341363135,6.300592123247959,60.785289153950984,18.74150632369347
122,2020-05-18,31000.0,-450.0,2094246,420264,513250,-92986,572017,1100264,-528247,621233,1101965,480732,52.61869904490686,7.131937703543727,22.954896416180333,-37.83039273777065
123,2020-05-15,31450.0,500.0,2594683,583076,416971,166105,588695,1184801,-596106,430001,1422912,992911,54.83953145721462,2.2208324123077574,38.26714091856307,15.31224450238274
124,2020-05-14,30950.0,-500.0,2117359,545517,806354,-260837,329046,745656,-416610,677447,1242796,565349,58.69557311726542,3.856041660050799,26.700668143663876,-11.566472774899196
125,2020-05-13,31450.0,-100.0,2292087,554493,446116,108377,420384,1249321,-828937,720560,1317210,596650,57.46771392185374,-1.2278591954116749,26.030861830288295,-0.6698063133755809
126,2020-05-12,31550.0,-600.0,1901590,283717,648500,-364783,229654,595909,-366255,731038,1388219,657181,73.00306585541573,15.535351933561984,34.55955279529236,8.528690965004067
127,2020-05-11,32150.0,-650.0,2124625,375213,505902,-130689,269799,846840,-577041,707730,1479613,771883,69.64113667117726,-3.3619291842384627,36.33031711478496,1.7707643194925993
128,2020-05-08,32800.0,350.0,1916592,306508,403194,-96686,834540,785704,48836,47850,775544,727694,40.46474158297645,-29.176395088200813,37.96812258425371,1.637805469468752
129,2020-05-07,32450.0,-250.0,2057759,655438,473460,181978,314633,1092778,-778145,596167,1087688,491521,52.857890549865175,12.393148966888724,23.886227687498877,-14.081894896754836
130,2020-05-06,32700.0,-300.0,3285676,719212,499895,219317,540870,2077787,-1536917,1317600,2025594,707994,61.64923139104403,8.791340841178858,21.54789455807572,-2.338333129423159
131,2020-05-04,33000.0,-1750.0,3135974,572127,814682,-242555,388547,1618887,-1230340,1472895,2175300,702405,69.36600877430745,7.716777383263413,22.398304322676143,0.8504097646004247
132,2020-04-29,34750.0,600.0,2470683,491373,421633,69740,1170929,650730,520199,-589939,808381,1398320,32.7189283287253,-36.64708044558215,56.59649578679256,34.19819146411642
133,2020-04-28,34150.0,-50.0,3681195,952381,685551,266830,597732,1066105,-468373,201543,2131082,1929539,57.89103810039946,25.172109771674165,52.41610400970337,-4.180391777089191
134,2020-04-27,34200.0,3100.0,6297287,1817637,763364,1054273,2251825,1116581,1135244,-2189517,2227825,4417342,35.3775363898771,-22.513501710522362,70.14674732150527,17.730643311801906
135,2020-04-24,31100.0,-200.0,1674947,447127,501283,-54156,597855,789399,-191544,245700,629965,384265,37.61104082696348,2.2335044370863812,22.941919953288075,-47.204827368217195
136,2020-04-23,31300.0,-200.0,1661682,506847,384987,121860,360290,746109,-385819,263959,794545,530586,47.81570721714504,10.204666390181558,31.93065821258219,8.988738259294117
137,2020-04-22,31500.0,-200.0,1816282,239736,465099,-225363,468629,798875,-330246,555609,1107917,552308,60.999173035905216,13.183465818760176,30.40871406532686,-1.5219441472553328
138,2020-04-21,31700.0,-200.0,2357333,519922,820173,-300251,721468,580484,140984,159267,1115943,956676,47.33921766674458,-13.659955369160635,40.582980851665845,10.174266786338986
139,2020-04-20,31900.0,-450.0,2712305,457331,810742,-353411,441907,1261647,-819740,1173151,1813067,639916,66.84598524133533,19.506767574590747,23.593069363511848,-16.989911488153997
140,2020-04-17,32350.0,450.0,3117460,549274,517185,32089,1062713,1347395,-284682,252593,1505473,1252880,48.291654103019766,-18.55433113831556,40.189128328831806,16.59605896531996
141,2020-04-16,31900.0,-1300.0,4032094,466156,862450,-396294,1252235,2513286,-1261051,1657345,2313703,656358,57.38216916569902,9.090515062679252,16.27834073312775,-23.910787595704058
142,2020-04-14,33200.0,650.0,1592187,540145,328213,211932,413203,548468,-135265,-76667,638839,715506,40.12336490625787,-17.25880425944115,44.938565633308144,28.660224900180395
143,2020-04-13,32550.0,-1100.0,2535276,366581,723077,-356496,362012,877891,-515879,872375,1806683,934308,71.26178767124368,31.138422764985812,36.85231903745391,-8.086246595854234
144,2020-04-10,33650.0,1150.0,3195991,812786,685207,127579,828717,654132,174585,-302164,1554488,1856652,48.63868515274292,-22.623102518500758,58.09315483053613,21.24083579308222
145,2020-04-09,32500.0,400.0,1758854,495429,801140,-305711,449081,468673,-19592,325303,814344,489041,46.299692868197134,-2.338992284545789,27.80452499184128,-30.28862983869485
146,2020-04-08,32100.0,-1000.0,2328277,525516,890684,-365168,397707,875463,-477756,842924,1405054,562130,60.3473727567639,14.047679888566769,24.143604906117268,-3.660920085724012
147,2020-04-07,33100.0,250.0,2588831,668621,789808,-121187,439446,968577,-529131,650318,1480764,830446,57.198171684439814,-3.1492010723240895,32.07803058600581,7.934425679888541
148,2020-04-06,32850.0,1700.0,1998703,842839,448746,394093,507201,652518,-145317,-248776,648663,897439,32.45419654646038,-24.743975137979433,44.901068342820324,12.823037756814514
149,2020-04-03,31150.0,-550.0,2312886,607914,866722,-258808,689488,922722,-233234,492042,1015484,523442,43.905492964201436,11.451296417741055,22.631552095520487,-22.269516247299837
150,2020-04-02,31700.0,100.0,2356609,846994,907884,-60890,532188,857211,-325023,385913,977427,591514,41.475993684145315,-2.4294992800561204,25.100218152438526,2.468666056918039
151,2020-04-01,31600.0,-2950.0,2918796,618484,1143583,-525099,701039,1269419,-568380,1093479,1599273,505794,54.79221569441647,13.316222010271154,17.32885751522203,-7.771360637216496
152,2020-03-31,34550.0,-200.0,2227158,789193,870737,-81544,654174,811274,-157100,238644,783791,545147,35.19242909573546,-19.599786598681007,24.477248583171917,7.148391067949888
153,2020-03-30,34750.0,-1000.0,2529780,1035624,741086,294538,839773,1296726,-456953,162415,654383,491968,25.86719003233483,-9.325239063400634,19.447066543335783,-5.030182039836134
154,2020-03-27,35750.0,2850.0,3789110,1249671,1162194,87477,1885646,1543878,341768,-429245,653793,1083038,17.25452678861263,-8.6126632437222,28.58291261008522,9.135846066749437
155,2020-03-26,32900.0,900.0,4079253,1444118,1379061,65057,1612523,1429885,182638,-247695,1022612,1270307,25.068609375294937,7.814082586682307,31.140676981790538,2.557764371705318
156,2020-03-25,32000.0,2850.0,4002728,1502207,1338824,163383,1200673,1204336,-3663,-159720,1299848,1459568,32.474052696061285,7.405443320766349,36.46433132603564,5.323654344245103
157,2020-03-24,29150.0,1500.0,2766834,1049009,948454,100555,877552,1021560,-144008,43453,840273,796820,30.369476448532872,-2.1045762475284135,28.798981073674824,-7.665350252360817
158,2020-03-23,27650.0,-3200.0,2779005,956731,1091108,-134377,789734,1137642,-347908,482285,1032540,550255,37.155024909994765,6.785548461461893,19.800432169067705,-8.99854890460712
159,2020-03-20,30850.0,4800.0,2772947,1070150,979812,90338,1121581,1130433,-8852,-81486,581216,662702,20.960227512462374,-16.19479739753239,23.89883398420525,4.098401815137546
160,2020-03-19,26050.0,-3000.0,3226552,1318596,1267048,51548,1228290,1467218,-238928,187380,679666,492286,21.064777508622207,0.1045499961598324,15.25733972364307,-8.64149426056218
161,2020-03-18,29050.0,-800.0,3437402,831892,934300,-102408,1889339,1892207,-2868,105276,716171,610895,20.834659431745255,-0.23011807687695196,17.77199757258534,2.514657848942271
162,2020-03-17,29850.0,-2250.0,2376047,791506,802274,-10768,567656,1176001,-608345,619113,1016885,397772,42.797343655239146,21.96268422349389,16.74091463678959,-1.0310829357957516
163,2020-03-16,32100.0,-800.0,2158001,439431,982068,-542637,1331196,924129,407067,135570,387374,251804,17.950594091476326,-24.84674956376282,11.668391256537879,-5.072523380251711
164,2020-03-13,32900.0,-550.0,3157352,1093524,1069732,23792,1662513,1586899,75614,-99406,401315,500721,12.710492843370014,-5.240101248106312,15.858890614666974,4.190499358129095
165,2020-03-12,33450.0,-1850.0,2428039,898247,967943,-69696,1038357,1156513,-118156,187852,491435,303583,20.23999614503721,7.529503301667196,12.503217617179955,-3.3556729974870194
166,2020-03-11,35300.0,150.0,1840394,648744,747677,-98933,914172,850508,63664,35269,277478,242209,15.077097621487573,-5.162898523549638,13.160714499177894,0.6574968819979397
167,2020-03-10,35150.0,0.0,2183412,717718,521033,196685,1194170,1386664,-192494,-4191,271524,275715,12.435765673175746,-2.6413319483118265,12.62771295568587,-0.5330015434920234
168,2020-03-09,35150.0,-2300.0,2015102,387047,568742,-181695,935964,1225605,-289641,471336,692091,220755,34.34520932439152,21.909443651215774,10.955028579198473,-1.672684376487398
169,2020-03-06,37450.0,-1250.0,1624871,391845,614404,-222559,641511,826059,-184548,407107,591515,184408,36.403812979615,2.0586036552234788,11.349085558176618,0.3940569789781456
170,2020-03-05,38700.0,-250.0,1192190,548978,767065,-218087,333800,323442,10358,207729,309412,101683,25.95324570747951,-10.450567272135487,8.529093516972965,-2.819992041203653
171,2020-03-04,38950.0,850.0,1601011,445031,659763,-214732,955465,704528,250937,-36205,200515,236720,12.524273724540306,-13.428971982939204,14.785657312785483,6.256563795812518
172,2020-03-03,38100.0,-300.0,1830298,502597,815093,-312496,939702,870630,69072,243424,387999,144575,21.198679122197586,8.67440539765728,7.898986940924374,-6.8866703718611095
173,2020-03-02,38400.0,-500.0,1696505,745596,703480,42116,669216,877188,-207972,165856,281693,115837,16.60431298463606,-4.594366137561526,6.827978697380792,-1.0710082435435817
174,2020-02-28,38900.0,-500.0,2342074,961150,772655,188495,1208058,1400142,-192084,3589,172866,169277,7.380894028113544,-9.223418956522515,7.227653780367316,0.39967508298652366
175,2020-02-27,39400.0,350.0,1667870,800096,680448,119648,711530,823925,-112395,-7253,156244,163497,9.367876393244078,1.986982365130534,9.802742419972779,2.575088639605463
176,2020-02-26,39050.0,-200.0,2439040,901982,773910,128072,1284769,1522447,-237678,109606,252289,142683,10.343782799790082,0.9759064065460041,5.849965560220414,-3.9527768597523645
177,2020-02-25,39250.0,200.0,1779148,729888,657045,72843,779124,895128,-116004,43161,270136,226975,15.183447357948863,4.8396645581587805,12.757510898475,6.907545338254585
178,2020-02-24,39050.0,-2100.0,1872964,671032,641593,29439,776703,1056308,-279605,250166,425229,175063,22.70353300971081,7.520085651761947,9.34684275832317,-3.410668140151829
179,2020-02-21,41150.0,-1050.0,1476170,452755,599326,-146571,786914,692315,94599,51972,236501,184529,16.021257714219907,-6.6822752954909035,12.50052500728236,3.153682248959189
180,2020-02-20,42200.0,400.0,1471921,384263,636645,-252382,993977,703314,290663,-38281,93681,131962,6.364539944738882,-9.656717769481023,8.965290936130403,-3.5352340711519563
181,2020-02-19,41800.0,50.0,1808110,510366,515098,-4732,1145341,1193490,-48149,52881,152403,99522,8.428856651420544,2.0643167066816615,5.504200518773747,-3.4610904173566563
182,2020-02-18,41750.0,-650.0,1530494,440452,498169,-57717,829659,868254,-38595,96312,260383,164071,17.01300364457489,8.584146993154347,10.720133499379939,5.215932980606192
183,2020-02-17,42400.0,-350.0,994095,275573,351524,-75951,490124,562336,-72212,148163,228398,80235,22.97547015124309,5.9624665066682,8.071160200986826,-2.6489732983931127
184,2020-02-14,42750.0,0.0,1304244,370993,402239,-31246,793606,814540,-20934,52180,139645,87465,10.7069689413944,-12.26850120984869,6.706183812231453,-1.3649763887553732
185,2020-02-13,42750.0,-750.0,1585289,366300,535058,-168758,759265,948526,-189261,358019,459724,101705,28.999381185386387,18.292412243991986,6.4155494676365,-0.2906343445949533
186,2020-02-12,43500.0,400.0,2163450,512695,462553,50142,1485341,1507824,-22483,-27659,165414,193073,7.645843444498371,-21.353537740888015,8.924310707434884,2.5087612397983845
187,2020-02-11,43100.0,-150.0,1505386,453568,351020,102548,756997,1059984,-302987,200439,294821,94382,19.58441223712722,11.93856879262885,6.269621213429645,-2.654689494005239
188,2020-02-10,43250.0,-1150.0,1392007,449876,507176,-57300,498135,839361,-341226,398526,443996,45470,31.896103970741525,12.311691733614303,3.2665065621078058,-3.0031146513218396
189,2020-02-07,44400.0,-850.0,1152443,435976,623891,-187915,370854,414197,-43343,231258,345613,114355,29.989596014726978,-1.906507956014547,9.92283349371726,6.656326931609454
190,2020-02-06,45250.0,1050.0,1087184,635858,412762,223096,327900,458765,-130865,-92231,123426,215657,11.352816082650223,-18.636779932076756,19.836292660671976,9.913459166954716
191,2020-02-05,44200.0,700.0,1414093,448321,743555,-295234,788104,505979,282125,13109,177668,164559,12.564095855081666,1.2112797724314426,11.637070546279487,-8.199222114392489
192,2020-02-04,43500.0,-350.0,1350137,382301,708320,-326019,711611,591657,119954,206065,256225,50160,18.97770374413856,6.413607889056893,3.7151785337339844,-7.921892012545502
193,2020-02-03,43850.0,-100.0,1438211,560994,685897,-124903,768781,653354,115427,9476,108436,98960,7.539644739193345,-11.438059004945213,6.88077062406003,3.165592090326046
194,2020-01-31,43950.0,150.0,1043074,502647,492915,9732,489591,442403,47188,-56920,50836,107756,4.873671474890564,-2.6659732643027807,10.330618920613494,3.449848296553464
195,2020-01-30,43800.0,-450.0,1451247,422843,572816,-149973,842364,795428,46936,103037,186040,83003,12.81932021220371,7.945648737313146,5.719426121122042,-4.6111927994914526
196,2020-01-29,44250.0,-250.0,1357149,435212,678175,-242963,731652,613492,118160,124803,190285,65482,14.020936536813569,1.2016163246098586,4.824967634357023,-0.8944584867650187
197,2020-01-28,44500.0,-2200.0,1494047,654640,890987,-236347,543905,456045,87860,148487,295502,147015,19.778628115447503,5.757691578633935,9.840051885917912,5.015084251560889
198,2020-01-23,46700.0,-850.0,892831,369177,572407,-203230,378960,261377,117583,85647,144694,59047,16.206202517609718,-3.5724255978377855,6.6134576420397595,-3.2265942438781527
199,2020-01-22,47550.0,200.0,827162,289460,248294,41166,504933,517519,-12586,-28580,32769,61349,3.961618159441561,-12.244584358168158,7.416805897756425,0.8033482557166653
200,2020-01-21,47350.0,-950.0,543206,306584,181513,125071,154233,320588,-166355,41284,82389,41105,15.167174147560964,11.205555988119404,7.567110819836305,0.15030492207988022
201,2020-01-20,48300.0,400.0,1039883,477004,482238,-5234,471778,353715,118063,-112829,91101,203930,8.760697116887188,-6.406477030673775,19.61086006791149,12.043749248075184
202,2020-01-17,47900.0,-100.0,1067206,492865,488399,4466,475780,478442,-2662,-1804,98561,100365,9.235424088695153,0.4747269718079643,9.404463618083108,-10.20639644982838
203,2020-01-16,48000.0,100.0,1063894,424055,515573,-91518,554550,470925,83625,7893,85289,77396,8.016682113067656,-1.2187419756274966,7.274784893983799,-2.1296787240993087
204,2020-01-15,47900.0,50.0,1051882,352308,387062,-34754,643008,581227,61781,-27027,56566,83593,5.377599388524568,-2.639082724543088,7.946994054466186,0.672209160482387
205,2020-01-14,47850.0,1150.0,1230507,449734,565591,-115857,702839,444752,258087,-142230,77934,220164,6.333486928558717,0.9558875400341487,17.89213714347013,9.945143089003944
206,2020-01-13,46700.0,-100.0,723834,434761,314995,119766,197844,321208,-123364,3598,91229,87631,12.60358037892666,6.270093450367943,12.106505082657074,-5.785632060813056
207,2020-01-10,46800.0,300.0,1223959,453817,636208,-182391,680402,479082,201320,-18929,89740,108669,7.331944942600202,-5.2716354363264575,8.878483674698254,-3.2280214079588205
208,2020-01-09,46500.0,350.0,1371428,683800,656675,27125,567172,631240,-64068,36943,120456,83513,8.783253659689025,1.451308717088823,6.089492120621717,-2.788991554076537
209,2020-01-08,46150.0,-850.0,1197780,468996,667761,-198765,592590,393175,199415,-650,136194,136844,11.370535490657717,2.587281830968692,11.424802551386733,5.335310430765016
210,2020-01-07,47000.0,400.0,817477,431894,392345,39549,324430,352982,-28552,-10997,61153,72150,7.480699762806782,-3.8898357278509357,8.825936387201109,-2.5988661641856243
211,2020-01-06,46600.0,-550.0,698224,279052,481984,-202932,346435,148744,197691,5241,72737,67496,10.417430509406724,2.9367307465999426,9.666811796787279,0.8408754095861699
212,2020-01-03,47150.0,600.0,1123490,438873,757350,-318477,624877,207988,416889,-98412,59740,158152,5.317359300038273,-5.100071209368451,14.076849816197742,4.410038019410463
213,2020-01-02,46550.0,-1100.0,1033855,372252,683100,-310848,432329,263237,169092,141756,229274,87518,22.176610840011413,16.85925153997314,8.465210305120157,-5.611639511077584
214,2019-12-30,47650.0,-400.0,955663,281926,444044,-162118,549573,447300,102273,59845,124164,64319,12.992446081934741,-9.184164758076673,6.730301371927133,-1.734908933193024
215,2019-12-27,48050.0,-1350.0,1278193,471358,755521,-284163,561446,387648,173798,110365,245389,135024,19.198117968100277,6.205671886165536,10.563662921014275,3.833361549087142
216,2019-12-26,49400.0,-50.0,717331,478720,289316,189404,69579,228109,-158530,-30874,169032,199906,23.56401716920083,4.365899201100554,27.868027451762156,17.304364530747883
217,2019-12-24,49450.0,-450.0,602123,426741,312981,113760,82073,228664,-146591,32831,93309,60478,15.496667624389037,-8.067349544811794,10.044127196602687,-17.82390025515947
218,2019-12-23,49900.0,850.0,878027,407668,321940,85728,403433,332400,71033,-156761,66926,223687,7.6223168535819505,-7.874350770807086,25.476095837599527,15.431968640996839
219,2019-12-20,49050.0,-350.0,1014948,396863,314461,82402,497380,620153,-122773,40371,120705,80334,11.89272750919259,4.270410655610639,7.9150853048629095,-17.561010532736617
220,2019-12-19,49400.0,0.0,1000540,517400,403320,114080,402255,515308,-113053,-1027,80885,81912,8.08413456733364,-3.808592941858949,8.186779139264797,0.2716938344018871
221,2019-12-18,49400.0,1450.0,1315621,385251,617913,-232662,851629,449326,402303,-169641,78741,248382,5.985082329941525,-2.099052237392115,18.87944932469153,10.692670185426735
222,2019-12-17,47950.0,-1100.0,2272935,830212,1004819,-174607,963460,1040188,-76728,251335,479263,227928,21.085644772067834,15.100562442126309,10.027915448528004,-8.851533876163527
223,2019-12-16,49050.0,-950.0,2082488,546052,865934,-319882,1398904,1024115,374789,-54907,137532,192439,6.604215726573215,-14.481429045494618,9.240821555754462,-0.7870938927735427
224,2019-12-13,50000.0,1650.0,1211381,490379,392859,97520,660134,414082,246052,-343572,60868,404440,5.0246784455097115,-1.5795372810635033,33.386688415948406,24.145866860193944
225,2019-12-12,48350.0,350.0,1715262,1178197,921667,256530,497914,655023,-157109,-99421,39151,138572,2.2825084447740345,-2.742170000735677,8.078765809538135,-25.307922606410273
226,2019-12-11,48000.0,-300.0,973843,404554,302790,101764,511931,620798,-108867,7103,57358,50255,5.889861096706554,3.607352651932519,5.160482747219008,-2.9182830623191274
227,2019-12-10,48300.0,250.0,813927,222574,275631,-53057,546790,415996,130794,-77737,44563,122300,5.475061031271846,-0.41480006543470793,15.025917557717092,9.865434810498083
228,2019-12-09,48050.0,1050.0,1066373,370361,395788,-25427,607017,400018,206999,-181572,88995,270567,8.345578892188756,2.8705178609169106,25.372641655405754,10.346724097688663
229,2019-12-06,47000.0,350.0,783218,299225,208205,91020,450187,458261,-8074,-82946,33806,116752,4.316295080041572,-4.029283812147185,14.906705412796947,-10.465936242608807
230,2019-12-05,46650.0,600.0,1123928,286193,351002,-64809,783323,648725,134598,-69789,54412,124201,4.841235381625869,0.524940301584297,11.05061890085486,-3.856086511942088
231,2019-12-04,46050.0,200.0,924902,319110,390411,-71301,583298,478044,105254,-33953,22494,56447,2.4320414487156476,-2.409193932910221,6.103024969131865,-4.947593931722994
232,2019-12-03,45850.0,-100.0,932941,367688,502523,-134835,533617,399145,134472,363,31636,31273,3.39099685832223,0.9589554096065824,3.3520876454138047,-2.7509373237180603
233,2019-12-02,45950.0,-100.0,698866,462492,296187,166305,203226,379616,-176390,10085,33148,23063,4.743112413538504,1.3521155552162738,3.3000603835356133,-0.0520272618781914
234,2019-11-29,46050.0,-500.0,844993,371873,393800,-21927,433549,386682,46867,-24940,39571,64511,4.682997373942743,-0.06011503959576103,7.634501114210414,4.3344407306748005
235,2019-11-28,46550.0,450.0,540476,269059,277931,-8872,257078,149639,107439,-98567,14339,112906,2.653031771993576,-2.0299656019491668,20.890104278450845,13.255603164240432
236,2019-11-27,46100.0,250.0,753439,352456,251451,101005,366574,432783,-66209,-34796,34409,69205,4.5669257896126965,1.9138940176191204,9.185216055977989,-11.704888222472857
237,2019-11-26,45850.0,-200.0,2137333,692513,307450,385063,1332350,1758492,-426142,41079,112470,71391,5.262165511878589,0.6952397222658924,3.3401907891751077,-5.845025266802882
238,2019-11-25,46050.0,-150.0,1217858,549904,429987,119917,620967,666005,-45038,-74879,46987,121866,3.8581673725508225,-1.4039981393277663,10.006585332608564,6.666394543433457
239,2019-11-22,46200.0,550.0,1097164,432276,422477,9799,640940,507744,133196,-142995,23948,166943,2.182718353865056,-1.6754490186857667,15.215865631756053,5.209280299147489
240,2019-11-21,45650.0,-300.0,1686894,674360,539160,135200,948844,1008079,-59235,-75965,63690,139655,3.7755780742595566,1.5928597203945007,8.278824869849558,-6.937040761906495
241,2019-11-20,45950.0,1050.0,2402413,735840,970307,-234467,1594360,938511,655849,-421382,72213,493595,3.0058528654315473,-0.7697252088280093,20.545801242334267,12.26697637248471
242,2019-11-19,44900.0,900.0,1834999,357557,447270,-89713,1427301,1033912,393389,-303676,50141,353817,2.73248105312319,-0.2733718123083575,19.281590889150348,-1.2642103531839197
243,2019-11-18,44000.0,300.0,738224,329829,270150,59679,368426,311423,57003,-116682,39969,156651,5.414210320986584,2.681729267863394,21.219982010880166,1.9383911217298184
244,2019-11-15,43700.0,0.0,1154688,619375,364522,254853,379282,577877,-198595,-56258,156031,212289,13.512827707571223,8.098617386584639,18.384966328566676,-2.8350156823134895
245,2019-11-14,43700.0,300.0,908957,599304,390390,208914,271635,370792,-99157,-109757,38018,147775,4.182596096405,-9.330231611166223,16.257644751071833,-2.1273215774948433
246,2019-11-13,43400.0,-150.0,786626,298028,319088,-21060,449326,409472,39854,-18794,39272,58066,4.9924614747033536,0.8098653782983538,7.381652780355595,-8.875991970716239
247,2019-11-12,43550.0,550.0,619591,278691,360790,-82099,279234,199146,80088,2011,61666,59655,9.952694600147517,4.960233125444163,9.62812565063082,2.246472870275224
248,2019-11-11,43000.0,-300.0,882908,296307,309975,-13668,520333,538319,-17986,31654,66268,34614,7.505651777988194,-2.4470428221593226,3.920453773213064,-5.707671877417756
249,합계,,,499184806,155836906,159952208,-4115302,169501035,174163396,-4662361,8777663,173846865,165069202,34.826153142169154,27.32050136418096,33.06775366876852,29.147299895555452
