,날짜,종가,대비,거래량,기관 매수,기관 매도,기관 순매수,외국인 매수,외국인 매도,외국인 순매수,개인 순매수,개인 매수,개인 매도,개인매수비율(%),개인매수비율증가(%p),개인매도비율(%),개인매도비율증가(%p)
0,2020-11-11,1571000.0,42000.0,41690,9976,13287,-3311,26602,7090,19512,-16201,5112,21313,12.261933317342288,,51.122571360038386,
1,2020-11-10,1529000.0,2000.0,31661,6740,14054,-7314,18432,12515,5917,1397,6489,5092,20.49524651779792,8.233313200455632,16.082877988692715,-35.03969337134567
2,2020-11-09,1527000.0,1000.0,21957,9394,7630,1764,7534,8994,-1460,-304,5029,5333,22.90385753973676,2.408611021938839,24.28838183722731,8.205503848534594
3,2020-11-06,1526000.0,-4000.0,19413,6972,9889,-2917,7378,4004,3374,-457,5063,5520,26.08046154638644,3.176604006649683,28.43455416473497,4.14617232750766
4,2020-11-05,1530000.0,25000.0,34779,9383,13584,-4201,17705,15374,2331,1870,7691,5821,22.11391931912936,-3.966542227257083,16.737111475315565,-11.697442689419404
5,2020-11-04,1505000.0,-12000.0,29280,9428,13194,-3766,9911,12421,-2510,6276,9941,3665,33.951502732240435,11.837583413111076,12.517076502732241,-4.220034972583324
6,2020-11-03,1517000.0,-14000.0,22826,7695,9857,-2162,8815,10814,-1999,4161,6316,2155,27.670200648383425,-6.28130208385701,9.440988346622273,-3.076088156109968
7,2020-11-02,1531000.0,31000.0,19283,7625,5037,2588,9390,4674,4716,-7304,2268,9572,11.761655344085465,-15.90854530429796,49.639578903697554,40.19859055707528
8,2020-10-30,1500000.0,-7000.0,26906,2956,8644,-5688,16497,16212,285,5403,7453,2050,27.700141232438863,15.938485888353398,7.619118412250056,-42.0204604914475
9,2020-10-29,1507000.0,-17000.0,23582,4516,12108,-7592,9873,8432,1441,6151,9193,3042,38.983122720719194,11.282981488280331,12.899669239250274,5.280550827000218
10,2020-10-28,1524000.0,-19000.0,18950,3670,8713,-5043,10284,8062,2222,2821,4996,2175,26.364116094986805,-12.61900662573239,11.477572559366754,-1.42209667988352
11,2020-10-27,1543000.0,28000.0,43164,5213,10121,-4908,35145,27104,8041,-3133,2806,5939,6.5007876934482445,-19.86332840153856,13.759151144472245,2.281578585105491
12,2020-10-26,1515000.0,-24000.0,18435,5589,8699,-3110,7096,7873,-777,3887,5750,1863,31.190669921345265,24.68988222789702,10.105777054515865,-3.6533740899563796
13,2020-10-23,1539000.0,0.0,26952,8808,12602,-3794,13780,10854,2926,868,4364,3496,16.191748293262094,-14.99892162808317,12.971208073612347,2.865431019096482
14,2020-10-22,1539000.0,-12000.0,34458,11004,17079,-6075,13333,13042,291,5784,10121,4337,29.3719890881653,13.180240794903206,12.586336989958792,-0.3848710836535556
15,2020-10-21,1551000.0,4000.0,20458,11075,10550,525,6457,8136,-1679,1154,2926,1772,14.302473360054746,-15.069515728110554,8.661648254961385,-3.9246887349974067
16,2020-10-20,1547000.0,-15000.0,18165,6876,6403,473,8933,8699,234,-707,2356,3063,12.969997247453897,-1.3324761126008493,16.862097440132125,8.20044918517074
17,2020-10-19,1562000.0,-9000.0,29547,15929,13672,2257,11047,13340,-2293,36,2571,2535,8.70139100416286,-4.268606243291037,8.579551223474464,-8.28254621665766
18,2020-10-16,1571000.0,2000.0,26034,12412,9545,2867,11883,11214,669,-3536,1739,5275,6.679726511484982,-2.0216644926778775,20.261965122532075,11.682413899057611
19,2020-10-15,1569000.0,23000.0,26730,6323,7673,-1350,18162,14713,3449,-2099,2245,4344,8.398802843247289,1.7190763317623068,16.251402918069584,-4.010562204462492
20,2020-10-14,1546000.0,-2000.0,23585,6144,6531,-387,14779,14768,11,376,2662,2286,11.28683485266059,2.888032009413301,9.69260122959508,-6.558801688474503
21,2020-10-13,1548000.0,-37000.0,25353,8087,10177,-2090,11089,11468,-379,2469,6177,3708,24.363980594012542,13.077145741351952,14.625488107916224,4.932886878321144
22,2020-10-12,1585000.0,45000.0,31235,17480,8749,8731,9583,6590,2993,-11724,4172,15896,13.356811269409317,-11.007169324603225,50.891627981431085,36.26613987351486
23,2020-10-08,1540000.0,27000.0,32935,13284,14335,-1051,18302,8817,9485,-8434,1349,9783,4.0959465614088355,-9.260864708000481,29.703962350083497,-21.18766563134759
24,2020-10-07,1513000.0,13000.0,19124,10789,5331,5458,6969,8376,-1407,-4051,1366,5417,7.142857142857142,3.046910581448307,28.325664087011088,-1.3782982630724092
25,2020-10-06,1500000.0,1000.0,18373,6165,8533,-2368,9837,6908,2929,-561,2371,2932,12.904805965275132,5.76194882241799,15.95819953192184,-12.367464555089247
26,2020-10-05,1499000.0,51000.0,37143,18353,8662,9691,15985,12770,3215,-12906,2805,15711,7.551894031176803,-5.352911934098329,42.29868346660205,26.340483934680208
27,2020-09-29,1448000.0,-21000.0,29073,9615,6941,2674,14574,19167,-4593,1919,4884,2965,16.79909194097616,9.247197909799358,10.198465930588519,-32.10021753601353
28,2020-09-28,1469000.0,50000.0,22430,8082,5395,2687,12091,10940,1151,-3838,2257,6095,10.062416406598306,-6.736675534377856,27.17342844404815,16.97496251345963
29,2020-09-25,1419000.0,1000.0,15061,7696,6678,1018,3957,6201,-2244,1226,3408,2182,22.627979549830687,12.565563143232382,14.4877498174092,-12.685678626638948
30,2020-09-24,1418000.0,-37000.0,25119,7670,7837,-167,8169,13256,-5087,5254,9280,4026,36.94414586567937,14.31616631584868,16.02770810939926,1.5399582919900592
31,2020-09-23,1455000.0,-18000.0,23970,8721,10526,-1805,7514,10589,-3075,4880,7735,2855,32.269503546099294,-4.674642319580073,11.910721735502712,-4.116986373896548
32,2020-09-22,1473000.0,-24000.0,22655,5642,11099,-5457,8892,7972,920,4537,8121,3584,35.84639152504966,3.576887978950367,15.819907305230632,3.9091855697279208
33,2020-09-21,1497000.0,-19000.0,16592,9198,5174,4024,3611,9018,-5407,1383,3783,2400,22.800144648023142,-13.046246877026519,14.464802314368368,-1.355104990862264
34,2020-09-18,1516000.0,8000.0,29963,7902,8527,-625,20069,15496,4573,-3948,1992,5940,6.64819944598338,-16.151945202039762,19.824450155191403,5.359647840823035
35,2020-09-17,1508000.0,2000.0,18622,6609,10190,-3581,5606,5500,106,3475,6407,2932,34.40554183224144,27.75734238625806,15.744817957254858,-4.0796321979365455
36,2020-09-16,1506000.0,-27000.0,16229,5114,6745,-1631,3549,7369,-3820,5451,7566,2115,46.62024770472611,12.214705872484672,13.032226261630415,-2.712591695624443
37,2020-09-15,1533000.0,14000.0,20656,5293,7220,-1927,11202,7977,3225,-1298,4161,5459,20.144268009295118,-26.475979695430993,26.428156467854375,13.39593020622396
38,2020-09-14,1519000.0,1000.0,18782,6879,9320,-2441,9004,7035,1969,472,2899,2427,15.434990948780747,-4.709277060514371,12.921946544563944,-13.506209923290431
39,2020-09-11,1518000.0,-9000.0,26302,6957,9215,-2258,16465,13261,3204,-946,2880,3826,10.949737662535169,-4.4852532862455785,14.546422325298455,1.6244757807345103
40,2020-09-10,1527000.0,17000.0,34347,10698,17392,-6694,20451,5057,15394,-8700,3198,11898,9.310856843392436,-1.6388808191427326,34.640579963315574,20.09415763801712
41,2020-09-09,1510000.0,17000.0,36196,12579,11036,1543,20981,15504,5477,-7020,2636,9656,7.282572659962428,-2.0282841834300083,26.676980881865397,-7.963599081450177
42,2020-09-08,1493000.0,18000.0,22557,7574,10120,-2546,12080,5325,6755,-4209,2903,7112,12.869619186948619,5.587046526986191,31.52901538325132,4.852034501385923
43,2020-09-07,1475000.0,22000.0,22370,4008,6300,-2292,13460,9800,3660,-1368,4902,6270,21.913276709879305,9.043657522930687,28.028609745194455,-3.500405638056865
44,2020-09-04,1453000.0,-30000.0,32181,4219,11928,-7709,13636,15986,-2350,10059,14326,4267,44.51695099592928,22.603674286049973,13.259376650818805,-14.76923309437565
45,2020-09-03,1483000.0,-16000.0,20737,6096,10088,-3992,6134,7655,-1521,5513,8507,2994,41.023291700824615,-3.4936592951046634,14.437961132275642,1.1785844814568378
46,2020-09-02,1499000.0,-14000.0,25102,7718,6352,1366,8363,15996,-7633,6267,9021,2754,35.937375507927655,-5.08591619289696,10.971237351605449,-3.4667237806701934
47,2020-09-01,1513000.0,40000.0,29672,11021,10061,960,15112,11387,3725,-4685,3539,8224,11.927069290913993,-24.010306217013664,27.716365597196006,16.745128245590557
48,2020-08-31,1473000.0,-36000.0,36969,16500,14986,1514,10472,18021,-7549,6035,9997,3962,27.04157537396197,15.114506083047976,10.717087289350538,-16.99927830784547
49,2020-08-28,1509000.0,10000.0,26011,9663,9977,-314,12988,11334,1654,-1340,3360,4700,12.917611779631693,-14.123963594330275,18.069278382222905,7.352191092872367
50,2020-08-27,1499000.0,-18000.0,21958,6721,12478,-5757,4633,4188,445,5312,10604,5292,48.292194188906095,35.3745824092744,24.100555606157208,6.031277223934303
51,2020-08-26,1517000.0,-22000.0,42308,6335,16794,-10459,20637,21037,-400,10859,15336,4477,36.24846364753711,-12.043730541368987,10.581923040559706,-13.518632565597501
52,2020-08-25,1539000.0,-4000.0,19954,7912,12531,-4619,6401,5204,1197,3422,5641,2219,28.270021048411348,-7.97844259912576,11.120577327854065,0.5386542872943583
53,2020-08-24,1543000.0,-20000.0,25732,7608,10711,-3103,9414,11595,-2181,5284,8710,3426,33.84890408829473,5.578883039883383,13.314161355510649,2.193584027656584
54,2020-08-21,1563000.0,63000.0,36757,13996,11071,2925,16710,9684,7026,-9951,6051,16002,16.462170470930708,-17.386733617364023,43.53456484479147,30.22040348928082
55,2020-08-20,1500000.0,-19000.0,36587,17786,26127,-8341,14297,5677,8620,-279,4504,4783,12.31038346953836,-4.151787001392348,13.072949408259765,-30.4616154365317
56,2020-08-19,1519000.0,19000.0,33302,13088,14695,-1607,16254,10092,6162,-4555,3960,8515,11.891177707044621,-0.4192057624937391,25.56903489279923,12.496085484539465
57,2020-08-18,1500000.0,-65000.0,50554,16926,13679,3247,21404,30020,-8616,5369,12224,6855,24.180084661945642,12.288906954901021,13.559757882660126,-12.009277010139105
58,2020-08-14,1565000.0,5000.0,26191,14420,11551,2869,4798,8528,-3730,861,6973,6112,26.623649345194917,2.4435646832492743,23.33626054751632,9.776502664856196
59,2020-08-13,1560000.0,12000.0,43833,19252,17069,2183,16525,18499,-1974,-209,8056,8265,18.37884698742956,-8.244802357765355,18.855656697009103,-4.480603850507219
60,2020-08-12,1548000.0,-25000.0,34961,13889,15951,-2062,12292,11830,462,1600,8780,7180,25.113698120763132,6.734851133333571,20.53716998941678,1.6815132924076757
61,2020-08-11,1573000.0,128000.0,93232,26105,33724,-7619,46794,18366,28428,-20809,20333,41142,21.80903552428351,-3.3046625964796235,44.12862536468165,23.591455375264875
62,2020-08-10,1445000.0,13000.0,36558,11829,17935,-6106,19732,7205,12527,-6421,4997,11418,13.668690847420537,-8.140344676862972,31.232561956343346,-12.896063408338307
63,2020-08-07,1432000.0,47000.0,65788,15497,19825,-4328,42507,14098,28409,-24081,7784,31865,11.831945035568797,-1.8367458118517401,48.43588496382319,17.203323007479845
64,2020-08-06,1385000.0,21000.0,26783,12914,11942,972,11663,6893,4770,-5742,2206,7948,8.236567972221186,-3.5953770633476108,29.67554045476608,-18.760344509057113
65,2020-08-05,1364000.0,10000.0,38836,9799,13154,-3355,20734,15654,5080,-1725,8303,10028,21.379647749510763,13.143079777289577,25.8214028221238,-3.854137632642278
66,2020-08-04,1354000.0,4000.0,27230,10205,11003,-798,11030,11752,-722,1520,5995,4475,22.016158648549393,0.6365108990386297,16.43408005875872,-9.38732276336508
67,2020-08-03,1350000.0,-21000.0,39951,8459,16397,-7938,20572,20422,150,7788,10920,3132,27.333483517308704,5.317324868759311,7.839603514305024,-8.594476544453697
68,2020-07-31,1371000.0,-14000.0,27006,8840,11449,-2609,13156,12389,767,1842,5010,3168,18.551433014885582,-8.782050502423122,11.730726505221062,3.8911229909160383
69,2020-07-30,1385000.0,-5000.0,31061,10349,12632,-2283,16713,7793,8920,-6637,3999,10636,12.874665979846108,-5.676767035039473,34.242297414764494,22.51157090954343
70,2020-07-29,1390000.0,40000.0,56276,11628,16604,-4976,40335,8992,31343,-26367,4313,30680,7.664013078399318,-5.210652901446791,54.51702324259009,20.2747258278256
71,2020-07-28,1350000.0,4000.0,37319,8932,19722,-10790,21734,7947,13787,-2997,6653,9650,17.827380154880892,10.163367076481574,25.85814196521879,-28.658881277371304
72,2020-07-27,1346000.0,23000.0,24832,6140,5988,152,14206,5967,8239,-8391,4486,12877,18.065399484536083,0.23801932965519157,51.85647551546392,25.998333550245132
73,2020-07-24,1323000.0,-18000.0,50471,12485,18983,-6498,14809,11698,3111,3387,23177,19790,45.921420221513344,27.85602073697726,39.21063581066355,-12.645839704800373
74,2020-07-23,1341000.0,-42000.0,100071,40713,33109,7604,14749,20114,-5365,-2239,44609,46848,44.57735008144218,-1.3440701400711674,46.81476151932128,7.604125708657733
75,2020-07-22,1383000.0,-2000.0,32388,12458,10843,1615,9371,11704,-2333,718,10559,9841,32.60158083240706,-11.975769249035118,30.384710386562926,-16.430051132758354
76,2020-07-21,1385000.0,64000.0,77971,26117,13239,12878,22079,18803,3276,-16154,29775,45929,38.18727475599902,5.585693923591961,58.905233997255394,28.520523610692468
77,2020-07-20,1321000.0,-24000.0,20409,4871,11607,-6736,5280,5987,-707,7443,10258,2815,50.26213925229066,12.074864496291639,13.792934489685923,-45.112299507569475
78,2020-07-17,1345000.0,6000.0,22386,6145,8932,-2787,10629,7048,3581,-794,5612,6406,25.069239703386042,-25.192899548904617,28.616099347806667,14.823164858120744
79,2020-07-16,1339000.0,-11000.0,25129,10386,14601,-4215,10445,7201,3244,971,4298,3327,17.103744677464285,-7.965495025921758,13.239683234509927,-15.37641611329674
80,2020-07-15,1350000.0,10000.0,38328,11738,10129,1609,23189,16146,7043,-8652,3401,12053,8.8734084742225,-8.230336203241784,31.44698392819871,18.20730069368878
81,2020-07-14,1340000.0,40000.0,42225,12221,13975,-1754,25631,9063,16568,-14814,4373,19187,10.356423919478981,1.4830154452564805,45.439905269390174,13.992921341191465
82,2020-07-13,1300000.0,5000.0,20748,6892,6385,507,8069,9342,-1273,766,5787,5021,27.891844997108155,17.535421077629174,24.19992288413341,-21.239982385256763
83,2020-07-10,1295000.0,-12000.0,27608,5801,11968,-6167,10025,10570,-545,6712,11782,5070,42.676035931614024,14.784190934505869,18.36424224862359,-5.835680635509821
84,2020-07-09,1307000.0,-10000.0,43377,11286,14120,-2834,17728,23530,-5802,8636,14363,5727,33.11201788966503,-9.56401804194899,13.20284943633723,-5.16139281228636
85,2020-07-08,1317000.0,-31000.0,41906,8609,11356,-2747,13193,26900,-13707,16454,20104,3650,47.974037130721136,14.862019241056103,8.709969932706533,-4.4928795036306965
86,2020-07-07,1348000.0,-8000.0,50630,10006,14543,-4537,33470,32187,1283,3254,7154,3900,14.12996247284219,-33.84407465787895,7.702942919217855,-1.0070270134886785
87,2020-07-06,1356000.0,-24000.0,33829,12301,6772,5529,12007,23158,-11151,5622,9521,3899,28.144491412693252,14.014528939851063,11.525614118064382,3.8226711988465274
88,2020-07-03,1380000.0,1000.0,41681,10180,10102,78,27511,19757,7754,-7832,3990,11822,9.572706988795854,-18.571784423897398,28.363043113169066,16.837428995104684
89,2020-07-02,1379000.0,53000.0,42001,11788,6690,5098,27182,7841,19341,-24439,3031,27470,7.216494845360824,-2.3562121434350303,65.40320468560272,37.04016157243365
90,2020-07-01,1326000.0,-20000.0,34636,12839,14399,-1560,8558,11275,-2717,4277,13239,8962,38.22323593948493,31.006741094124106,25.874812333987755,-39.52839235161496
91,2020-06-30,1346000.0,46000.0,76009,31534,18506,13028,24115,18877,5238,-18266,20360,38626,26.786301622176325,-11.436934317308605,50.81766632898736,24.942853994999602
92,2020-06-29,1300000.0,-37000.0,24018,9294,12512,-3218,5014,6325,-1311,4529,9710,5181,40.42801232409027,13.641710701913944,21.571321508868348,-29.24634482011901
93,2020-06-26,1337000.0,60000.0,48453,8456,15638,-7182,33090,8380,24710,-17528,6907,24435,14.255051286814027,-26.17296103727624,50.43031391245124,28.858992403582892
94,2020-06-25,1277000.0,-68000.0,45849,10098,26884,-16786,11736,13268,-1532,18318,24015,5697,52.37845972649349,38.123408439679466,12.425570895766539,-38.0047430166847
95,2020-06-24,1345000.0,24000.0,35176,11488,10336,1152,18006,10183,7823,-8975,5682,14657,16.153058903798044,-36.22540082269545,41.667614282465316,29.242043386698775
96,2020-06-23,1321000.0,57000.0,52597,12226,13541,-1315,31363,14373,16990,-15675,9008,24683,17.126452079015912,0.9733931752178684,46.92853204555393,5.260917763088614
97,2020-06-22,1264000.0,-23000.0,46210,8750,9147,-397,23552,33053,-9501,9898,13908,4010,30.0973815191517,12.970929440135787,8.677775373295823,-38.250756672258106
98,2020-06-19,1287000.0,13000.0,49256,6245,14701,-8456,30051,28223,1828,6628,12960,6332,26.311515348383953,-3.785866170767747,12.855286665583886,4.177511292288063
99,2020-06-18,1274000.0,-14000.0,38772,7722,18659,-10937,23933,16017,7916,3021,7117,4096,18.356030124832355,-7.955485223551598,10.564324770452904,-2.290961895130982
100,2020-06-17,1288000.0,-12000.0,41485,8789,21289,-12500,22961,13698,9263,3237,9735,6498,23.466313125225984,5.110283000393629,15.663492828733277,5.099168058280373
101,2020-06-16,1300000.0,30000.0,34637,13602,8950,4652,8586,16272,-7686,3034,12449,9415,35.9413344111788,12.475021285952817,27.18191529289488,11.518422464161604
102,2020-06-15,1270000.0,-55000.0,47831,8016,14344,-6328,17164,23178,-6014,12342,22651,10309,47.35631703288662,11.414982621707821,21.55296774058665,-5.628947552308233
103,2020-06-12,1325000.0,-35000.0,37370,10806,14792,-3986,10273,11235,-962,4948,16291,11343,43.59379181161359,-3.7625252212730302,30.353224511640352,8.800256771053704
104,2020-06-11,1360000.0,-11000.0,56280,17029,27975,-10946,9885,20503,-10618,21564,29366,7802,52.178393745557926,8.584601933944334,13.86282871357498,-16.49039579806537
105,2020-06-10,1371000.0,-3000.0,28627,12926,7351,5575,7085,17343,-10258,4683,8616,3933,30.09746043944528,-22.080933306112648,13.738778076640934,-0.12405063693404728
106,2020-06-09,1374000.0,-5000.0,32971,7946,16543,-8597,13490,12983,507,8090,11535,3445,34.98529010342422,4.887829663978941,10.448576021352098,-3.2902020552888356
107,2020-06-08,1379000.0,-22000.0,37072,10343,13324,-2981,7815,19907,-12092,15073,18914,3841,51.01963746223564,16.034347358811424,10.360919292188173,-0.08765672916392475
108,2020-06-05,1401000.0,-2000.0,33992,16806,7099,9707,14124,22227,-8103,-1604,3062,4666,9.008001882795952,-42.01163557943969,13.72675923746764,3.3658399452794665
109,2020-06-04,1403000.0,16000.0,63330,24442,17812,6630,29950,29583,367,-6997,8938,15935,14.11337438812569,5.105372505329738,25.161850623717037,11.435091386249397
110,2020-06-03,1387000.0,17000.0,48995,22152,10480,11672,19998,30167,-10169,-1503,6845,8348,13.970813348300847,-0.1425610398248427,17.03847331360343,-8.123377310113607
111,2020-06-02,1370000.0,7000.0,31065,11476,8953,2523,12076,16791,-4715,2192,7513,5321,24.184773861258652,10.213960512957804,17.128601319813296,0.09012800620986638
112,2020-06-01,1363000.0,-7000.0,42182,7960,8350,-390,18778,26892,-8114,8504,15444,6940,36.61277322080508,12.42799935954643,16.452515290882367,-0.6760860289309285
113,2020-05-29,1370000.0,-15000.0,54088,7478,10889,-3411,41366,38422,2944,467,5244,4777,9.69531134447567,-26.917461876329412,8.831903564561456,-7.620611726320911
114,2020-05-28,1385000.0,-5000.0,33510,11274,14137,-2863,14824,15083,-259,3122,7412,4290,22.1187705162638,12.423459171788132,12.802148612354522,3.9702450477930658
115,2020-05-27,1390000.0,-10000.0,28837,7212,12077,-4865,12651,12040,611,4254,8974,4720,31.119741998127402,9.000971481863601,16.367860734473073,3.5657121221185513
116,2020-05-26,1400000.0,0.0,23917,11721,6918,4803,8109,10123,-2014,-2789,4087,6876,17.088263578207968,-14.031478419919434,28.749425095120625,12.381564360647552
117,2020-05-25,1400000.0,3000.0,28841,10296,9246,1050,11818,12863,-1045,-5,6727,6732,23.324433965535178,6.23617038732721,23.341770396310807,-5.407654698809818
118,2020-05-22,1397000.0,-15000.0,24947,5859,12490,-6631,6670,6950,-280,6911,12418,5507,49.77752836012346,26.453094394588284,22.074798572974707,-1.2669718233360996
119,2020-05-21,1412000.0,-4000.0,55863,6305,18696,-12391,35777,29790,5987,6404,13781,7377,24.669280203354635,-25.108248156768827,13.20552064872993,-8.869277924244777
120,2020-05-20,1416000.0,-1000.0,30145,7600,8439,-839,11941,17759,-5818,6657,10604,3947,35.17664620998507,10.507366006630438,13.09338198706253,-0.11213866166739983
121,2020-05-19,1417000.0,-20000.0,31604,12147,12953,-806,7834,13835,-6001,6807,11623,4816,36.77699025439818,1.6003440444131058,15.238577395266423,2.145195408203893
122,2020-05-18,1437000.0,-38000.0,31969,6825,12285,-5460,11717,15732,-4015,9475,13427,3952,42.00006256060559,5.223072306207413,12.361975663924426,-2.8766017313419976
123,2020-05-15,1475000.0,20000.0,29592,8887,9109,-222,16589,11505,5084,-4862,4116,8978,13.909164639091646,-28.090897921513946,30.339280886726144,17.977305222801718
124,2020-05-14,1455000.0,18000.0,40839,14963,15539,-576,22023,14353,7670,-7094,3853,10947,9.434609074659027,-4.4745555644326185,26.80525967824873,-3.5340212084774123
125,2020-05-13,1437000.0,18000.0,30396,7526,11048,-3522,18512,12909,5603,-2081,4358,6439,14.337412817475984,4.902803742816957,21.18370838268193,-5.6215512955668
126,2020-05-12,1419000.0,-17000.0,35531,5381,11288,-5907,25260,19135,6125,-218,4890,5108,13.762629816216826,-0.5747830012591582,14.376178548309927,-6.807529834372005
127,2020-05-11,1436000.0,16000.0,31434,5208,15910,-10702,23516,5754,17762,-7060,2710,9770,8.621238149774129,-5.141391666442697,31.080995100846216,16.70481655253629
128,2020-05-08,1420000.0,18000.0,45632,7093,11559,-4466,33066,23948,9118,-4652,5473,10125,11.993776297335202,3.372538147561073,22.188376577840113,-8.892618523006103
129,2020-05-07,1402000.0,21000.0,41840,8757,12591,-3834,28509,18657,9852,-6018,4574,10592,10.932122370936902,-1.0616539263983,25.315487571701723,3.12711099386161
130,2020-05-06,1381000.0,19000.0,38996,10282,13343,-3061,23606,19653,3953,-892,5108,6000,13.098779361985843,2.1666569910489404,15.38619345573905,-9.929294115962673
131,2020-05-04,1362000.0,-24000.0,46930,10231,20619,-10388,28015,18681,9334,1054,8684,7630,18.50415512465374,5.405375762667896,16.258256978478585,0.8720635227395341
132,2020-04-29,1386000.0,15000.0,38211,10469,10187,282,21061,15128,5933,-6215,6681,12896,17.48449399387611,-1.019661130777628,33.7494438774175,17.491186898938913
133,2020-04-28,1371000.0,-24000.0,56479,13177,13522,-345,28696,34576,-5880,6225,14606,8381,25.86093946422564,8.37644547034953,14.839143752545194,-18.910300124872304
134,2020-04-27,1395000.0,-39000.0,44795,10501,18506,-8005,19551,16879,2672,5333,14743,9410,32.91215537448376,7.051215910258119,21.00680879562451,6.167665043079317
135,2020-04-24,1434000.0,-10000.0,75610,13715,18179,-4464,51609,35852,15757,-11293,10286,21579,13.60402063219151,-19.30813474229225,28.53987567782039,7.533066882195879
136,2020-04-23,1444000.0,107000.0,148170,34821,39409,-4588,93344,43590,49754,-45166,20005,65171,13.501383545926975,-0.10263708626453472,43.983937369238035,15.444061691417645
137,2020-04-22,1337000.0,38000.0,72655,42346,20873,21473,16620,26565,-9945,-11528,13689,25217,18.84109834147684,5.339714795549865,34.707865941779644,-9.27607142745839
138,2020-04-21,1299000.0,37000.0,97720,38438,17315,21123,27777,42390,-14613,-6510,31505,38015,32.24007367990176,13.398975338424922,38.90196479738027,4.194098855600629
139,2020-04-20,1262000.0,13000.0,61136,22622,13733,8889,27850,32793,-4943,-3946,10664,14610,17.443077728343365,-14.796995951558397,23.897539911018058,-15.004424886362216
140,2020-04-17,1249000.0,58000.0,62084,16674,10916,5758,33822,13725,20097,-25855,11588,37443,18.665034469428516,1.221956741085151,60.31022485664583,36.412684945627774
141,2020-04-16,1191000.0,-9000.0,52827,11058,10142,916,28089,36900,-8811,7895,13680,5785,25.895848713725933,7.230814244297417,10.950839532814658,-49.35938532383118
142,2020-04-14,1200000.0,3000.0,37782,16263,6775,9488,15158,24329,-9171,-317,6361,6678,16.83605949923244,-9.059789214493492,17.675083373034777,6.724243840220119
143,2020-04-13,1197000.0,-18000.0,26824,12846,14858,-2012,4844,7085,-2241,4253,9134,4881,34.051595586042346,17.215536086809905,18.196391291380852,0.5213079183460749
144,2020-04-10,1215000.0,-40000.0,38315,9983,17075,-7092,5397,13881,-8484,15576,22935,7359,59.85906303014485,25.807467444102507,19.20657705859324,1.0101857672123877
145,2020-04-09,1255000.0,44000.0,37474,14755,13210,1545,14262,14697,-435,-1110,8457,9567,22.56764690185195,-37.2914161282929,25.529700592410737,6.323123533817498
146,2020-04-08,1211000.0,-12000.0,36450,12295,14104,-1809,13580,13708,-128,1937,10575,8638,29.01234567901235,6.444698777160397,23.698216735253773,-1.8314838571569645
147,2020-04-07,1223000.0,0.0,60943,17138,15055,2083,25480,33761,-8281,6198,18325,12127,30.069080944489112,1.0567352654767639,19.89892194345536,-3.7992947917984132
148,2020-04-06,1223000.0,59000.0,60263,28167,6454,21713,21139,24176,-3037,-18676,10957,29633,18.18196903572673,-11.887111908762382,49.17279259246967,29.27387064901431
149,2020-04-03,1164000.0,29000.0,48374,16017,11802,4215,24170,15866,8304,-12519,8187,20706,16.924380865754333,-1.2575881699723972,42.80398561210568,-6.368806980363992
150,2020-04-02,1135000.0,64000.0,56498,19641,11061,8580,27647,16269,11378,-19958,9210,29168,16.30146199865482,-0.6229188670995143,51.62660625154872,8.822620639443045
151,2020-04-01,1071000.0,-49000.0,66300,13485,17417,-3932,27598,39631,-12033,15965,25217,9252,38.03469079939668,21.73322880074186,13.954751131221718,-37.671855120327
152,2020-03-31,1120000.0,20000.0,53853,15764,16185,-421,24120,21526,2594,-2173,13969,16142,25.939130596252763,-12.095560203143915,29.974188995970515,16.019437864748795
153,2020-03-30,1100000.0,-9000.0,51265,16130,11648,4482,24417,31605,-7188,2706,10718,8012,20.907051594655222,-5.032079001597541,15.628596508339024,-14.34559248763149
154,2020-03-27,1109000.0,18000.0,65208,19264,13890,5374,29118,35903,-6785,1411,16826,15415,25.80358238252975,4.896530787874529,23.63973745552693,8.011140947187906
155,2020-03-26,1091000.0,-29000.0,82915,21267,14052,7215,34843,55111,-20268,13053,26805,13752,32.32828800578906,6.524705623259312,16.585660013266597,-7.054077442260333
156,2020-03-25,1120000.0,-24000.0,92747,25410,19427,5983,23632,56458,-32826,26843,43705,16862,47.122817988722005,14.794529982932943,18.18064196146506,1.5949819481984626
157,2020-03-24,1144000.0,78000.0,69628,26385,17689,8696,28915,34423,-5508,-3188,14328,17516,20.57792841960131,-26.544889569120695,25.15654621703912,6.975904255574061
158,2020-03-23,1066000.0,-44000.0,75697,26642,19637,7005,35437,46632,-11195,4190,13618,9428,17.990144919877935,-2.5877834997233755,12.454918953194975,-12.701627263844147
159,2020-03-20,1110000.0,13000.0,79664,24000,14861,9139,38747,57633,-18886,9747,16917,7170,21.235438843141193,3.245293923263258,9.00030126531432,-3.4546176878806545
160,2020-03-19,1097000.0,-36000.0,94466,46803,17678,29125,34392,64644,-30252,1127,13271,12144,14.048440708826456,-7.186998134314736,12.85541888086719,3.855117615552869
161,2020-03-18,1133000.0,42000.0,119151,52045,21310,30735,50140,76957,-26817,-3918,16966,20884,14.239074787454575,0.19063407862811843,17.527339258587844,4.671920377720655
162,2020-03-17,1091000.0,1000.0,97311,27422,11896,15526,60770,77191,-16421,895,9119,8224,9.370985808387541,-4.868088979067034,8.451254226140929,-9.076085032446915
163,2020-03-16,1090000.0,-50000.0,66839,13378,13970,-592,38876,48068,-9192,9784,14585,4801,21.82109247594967,12.450106667562128,7.182932120468588,-1.2683221056723406
164,2020-03-13,1140000.0,-20000.0,119769,26987,34684,-7697,84055,76670,7385,312,8727,8415,7.286526563634997,-14.534565912314672,7.026025098314255,-0.15690702215433294
165,2020-03-12,1160000.0,-58000.0,89277,29952,23632,6320,41647,57913,-16266,9946,17678,7732,19.80129260615836,12.514766042523362,8.660685282883609,1.6346601845693538
166,2020-03-11,1218000.0,-37000.0,45214,14134,17082,-2948,20492,24604,-4112,7060,10588,3528,23.417525545185118,3.6162329390267587,7.802892909275888,-0.8577923736077206
167,2020-03-10,1255000.0,4000.0,48845,27707,15387,12320,16687,28634,-11947,-373,4451,4824,9.112498720442215,-14.305026824742903,9.876138806428498,2.07324589715261
168,2020-03-09,1251000.0,-33000.0,50860,17188,12349,4839,27468,34045,-6577,1738,6204,4466,12.198191112858828,3.085692392416613,8.78096736138419,-1.0951714450443077
169,2020-03-06,1284000.0,-14000.0,41595,9471,16071,-6600,28284,22363,5921,679,3840,3161,9.231878831590336,-2.9663122812684914,7.599471090275274,-1.1814962711089168
170,2020-03-05,1298000.0,29000.0,52229,17353,14615,2738,29956,29254,702,-3440,4920,8360,9.420053992992399,0.18817516140206259,16.00643320760497,8.406962117329698
171,2020-03-04,1269000.0,37000.0,54284,18676,15040,3636,30241,28203,2038,-5674,5367,11041,9.886891164984156,0.46683717199175767,20.339326505047527,4.332893297442556
172,2020-03-03,1232000.0,22000.0,76694,12697,17677,-4980,56154,51718,4436,544,7843,7299,10.22635408245756,0.3394629174734032,9.51704175033249,-10.822284754715037
173,2020-03-02,1210000.0,-11000.0,71043,21535,14725,6810,35092,50598,-15506,8696,14416,5720,20.291935869825316,10.065581787367757,8.05146179074645,-1.4655799595860408
174,2020-02-28,1221000.0,-25000.0,69915,20401,17780,2621,36314,44877,-8563,5942,13200,7258,18.88006865479511,-1.411867215030206,10.381177143674462,2.3297153529280124
175,2020-02-27,1246000.0,-31000.0,62741,15767,16894,-1127,28401,40780,-12379,13506,18573,5067,29.60265217322006,10.722583518424951,8.076058717584992,-2.3051184260894697
176,2020-02-26,1277000.0,-17000.0,54650,16357,16290,67,29696,36070,-6374,6307,8597,2290,15.731015553522415,-13.871636619697647,4.190301921317475,-3.8857567962675175
177,2020-02-25,1294000.0,16000.0,61641,18179,12487,5692,33915,45063,-11148,5456,9547,4091,15.488068006683864,-0.24294754683855047,6.636816404665725,2.446514483348251
178,2020-02-24,1278000.0,-86000.0,67766,19294,20992,-1698,26620,41276,-14656,16354,21852,5498,32.24625918602249,16.758191179338628,8.113213115721749,1.4763967110560232
179,2020-02-21,1364000.0,-8000.0,48179,9722,16897,-7175,31942,27991,3951,3224,6515,3291,13.522489051246394,-18.723770134776096,6.830776894497603,-1.2824362212241454
180,2020-02-20,1372000.0,-38000.0,58831,13824,23075,-9251,34705,31641,3064,6187,10302,4115,17.511176080637757,3.9886870293913628,6.994611684316092,0.16383478981848842
181,2020-02-19,1410000.0,20000.0,26329,14137,10263,3874,10875,9670,1205,-5079,1317,6396,5.002088951346424,-12.509087129291332,24.29260511223366,17.297993427917568
182,2020-02-18,1390000.0,-7000.0,34561,12469,13681,-1212,20048,18608,1440,-228,2044,2272,5.914180723937386,0.9120917725909612,6.573883857527271,-17.718721254706388
183,2020-02-17,1397000.0,8000.0,27878,11142,9627,1515,15658,14996,662,-2177,1078,3255,3.8668484109333523,-2.0473323130040333,11.675873448597459,5.101989591070188
184,2020-02-14,1389000.0,-14000.0,42012,7928,10104,-2176,30759,29103,1656,520,3325,2805,7.9144054079786725,4.04755699704532,6.676663810339903,-4.999209638257556
185,2020-02-13,1403000.0,5000.0,42792,15454,17800,-2346,25446,20890,4556,-2210,1892,4102,4.421387175172929,-3.4930182328057438,9.585903907272387,2.909240096932484
186,2020-02-12,1398000.0,16000.0,41677,14336,8772,5564,25040,26055,-1015,-4549,2301,6850,5.521030784365477,1.0996436091925483,16.435923890875063,6.850019983602676
187,2020-02-11,1382000.0,26000.0,36979,12154,7046,5108,23306,22468,838,-5946,1519,7465,4.107736823602585,-1.4132939607628918,20.18713323778361,3.7512093469085457
188,2020-02-10,1356000.0,4000.0,31814,7095,8787,-1692,22719,18110,4609,-2917,2000,4917,6.286540516753631,2.1788036931510453,15.4554598604388,-4.7316733773448085
189,2020-02-07,1352000.0,-2000.0,58273,14432,16645,-2213,40396,36739,3657,-1444,3445,4889,5.91182880579342,-0.3747117109602103,8.389820328454,-7.0656395319848
190,2020-02-06,1354000.0,52000.0,69729,21115,13304,7811,43874,39214,4660,-12471,4740,17211,6.79774555780235,0.8859167520089297,24.682700167792454,16.292879839338454
191,2020-02-05,1302000.0,33000.0,58788,11534,22286,-10752,41101,22565,18536,-7784,6153,13937,10.466421718718106,3.668676160915756,23.707219160372865,-0.9754810074195888
192,2020-02-04,1269000.0,19000.0,44714,11643,18695,-7052,25421,20604,4817,2235,7650,5415,17.1087355190768,6.642313800358693,12.110301024287695,-11.59691813608517
193,2020-02-03,1250000.0,-8000.0,47434,20222,16724,3498,17776,26177,-8401,4903,9436,4533,19.89290382426108,2.7841683051842807,9.556436311506515,-2.5538647127811807
194,2020-01-31,1258000.0,-4000.0,50358,10504,17258,-6754,32815,29984,2831,3923,7039,3116,13.977918106358473,-5.914985717902606,6.187696095952977,-3.3687402155535375
195,2020-01-30,1262000.0,-34000.0,72600,10871,31625,-20754,46678,38420,8258,12496,15051,2555,20.731404958677686,6.753486852319213,3.5192837465564737,-2.6684123493965033
196,2020-01-29,1296000.0,43000.0,132198,29753,46909,-17156,92028,66583,25445,-8289,10417,18706,7.879846896322183,-12.851558062355503,14.149987140501368,10.630703393944895
197,2020-01-28,1253000.0,-96000.0,98803,23219,46356,-23137,49588,44684,4904,18233,25996,7763,26.310941975446088,18.431095079123907,7.857048875034159,-6.2929382654672095
198,2020-01-23,1349000.0,-19000.0,50508,13480,19111,-5631,31371,28497,2874,2757,5657,2900,11.200205907974976,-15.110736067471112,5.741664686782292,-2.115384188251867
199,2020-01-22,1368000.0,25000.0,39024,14112,8327,5785,22992,26405,-3413,-2372,1920,4292,4.920049200492005,-6.280156707482971,10.998359983599835,5.2566952968175436
200,2020-01-21,1343000.0,-44000.0,50018,14844,13382,1462,25081,33818,-8737,7275,10093,2818,20.17873565516414,15.258686454672134,5.633971770162741,-5.364388213437094
201,2020-01-20,1387000.0,-19000.0,45475,15622,19895,-4273,23887,21236,2651,1622,5966,4344,13.119296316657506,-7.059439338506634,9.552501374381528,3.9185296042187865
202,2020-01-17,1406000.0,1000.0,35291,11723,11731,-8,20879,20975,-96,104,2689,2585,7.619506389731093,-5.499789926926413,7.324813691876115,-2.2276876825054126
203,2020-01-16,1405000.0,-17000.0,33389,8361,9250,-889,20292,22614,-2322,3211,4736,1525,14.184312198628291,6.564805808897198,4.567372487945132,-2.7574412039309832
204,2020-01-15,1422000.0,11000.0,42809,10141,12461,-2320,30117,25030,5087,-2767,2551,5318,5.9590273073419135,-8.225284891286378,12.422621411385457,7.855248923440325
205,2020-01-14,1411000.0,7000.0,47813,10494,12020,-1526,31071,30852,219,1307,6248,4941,13.067575763913581,7.1085484565716675,10.334009578984794,-2.0886118324006624
206,2020-01-13,1404000.0,61000.0,49449,21278,10599,10679,20637,24737,-4100,-6579,7534,14113,15.235899613743452,2.1683238498298714,28.540516491738966,18.206506912754172
207,2020-01-10,1343000.0,19000.0,22346,11438,10905,533,7409,5923,1486,-2019,3499,5518,15.658283361675467,0.42238374793201494,24.693457442047794,-3.847059049691172
208,2020-01-09,1324000.0,-21000.0,41494,16742,11767,4975,18152,26932,-8780,3805,6600,2795,15.905914108063818,0.24763074638835114,6.73591362606642,-17.957543815981374
209,2020-01-08,1345000.0,2000.0,43472,29708,17107,12601,7281,17500,-10219,-2382,6483,8865,14.913047478836953,-0.9928666292268655,20.392436510857564,13.656522884791144
210,2020-01-07,1343000.0,94000.0,62787,26970,13038,13932,29964,6399,23565,-37497,5853,43350,9.32199340627837,-5.591054072558583,69.04295475177983,48.65051824092227
211,2020-01-06,1249000.0,-14000.0,19929,7601,10422,-2821,6614,7632,-1018,3839,5714,1875,28.671784836168396,19.349791429890026,9.408399819358722,-59.63455493242111
212,2020-01-03,1263000.0,-3000.0,29170,13989,16123,-2134,10449,6231,4218,-2084,4732,6816,16.22214604045252,-12.449638795715874,23.366472403153928,13.958072583795206
213,2020-01-02,1266000.0,5000.0,24426,12539,11744,795,7999,6843,1156,-1951,3888,5839,15.9174649963154,-0.30468104413712105,23.90485548186359,0.5383830787096606
214,2019-12-30,1261000.0,3000.0,14787,9185,2237,6948,4801,10349,-5548,-1400,801,2201,5.4169202678028,-10.500544728512601,14.884696016771489,-9.0201594650921
215,2019-12-27,1258000.0,1000.0,21526,9940,13122,-3182,6556,5529,1027,2155,5030,2875,23.36709095976958,17.950170691966782,13.355941651955774,-1.5287543648157147
216,2019-12-26,1257000.0,-2000.0,13947,7896,5213,2683,2484,5607,-3123,440,3567,3127,25.575392557539256,2.208301597769676,22.42059224205922,9.064650590103447
217,2019-12-24,1259000.0,-3000.0,13327,7347,4931,2416,3407,6337,-2930,514,2573,2059,19.30667066856757,-6.268721888971687,15.44983867336985,-6.970753568689371
218,2019-12-23,1262000.0,-11000.0,19108,9416,7141,2275,4632,10394,-5762,3487,5060,1573,26.481055055474144,7.174384386906574,8.23215407159305,-7.217684601776801
219,2019-12-20,1273000.0,7000.0,28045,7152,8753,-1601,17611,16487,1124,477,3282,2805,11.702620788019255,-14.77843426745489,10.00178284899269,1.7696287773996406
220,2019-12-19,1266000.0,-3000.0,21073,9541,7211,2330,8074,12251,-4177,1847,3458,1611,16.409623689080817,4.707002901061562,7.644853604137997,-2.356929244854693
221,2019-12-18,1269000.0,-10000.0,23207,7930,10041,-2111,10888,11526,-638,2749,4389,1640,18.91239712155815,2.5027734324773334,7.066833283061145,-0.5780203210768518
222,2019-12-17,1279000.0,7000.0,28672,10548,9278,1270,16224,13943,2281,-3551,1900,5451,6.626674107142858,-12.285723014415293,19.011579241071427,11.944745958010282
223,2019-12-16,1272000.0,26000.0,46014,21185,7272,13913,23207,23410,-203,-13710,1622,15332,3.5250141261355243,-3.1016599810073333,33.3202938236189,14.30871458254747
224,2019-12-13,1246000.0,-31000.0,69877,23221,15976,7245,20848,47280,-26432,19187,25808,6621,36.933468809479514,33.40845468334399,9.475220745023398,-23.845073078595497
225,2019-12-12,1277000.0,22000.0,45147,27006,24554,2452,16906,14704,2202,-4654,1235,5889,2.7355084501738762,-34.19796035930564,13.044056083460696,3.5688353384372977
226,2019-12-11,1255000.0,-10000.0,27959,10046,7983,2063,12197,19001,-6804,4741,5716,975,20.444221896348225,17.70871344617435,3.4872491863085235,-9.556806897152171
227,2019-12-10,1265000.0,-2000.0,17458,4230,3821,409,12191,12853,-662,253,1037,784,5.939970214228434,-14.50425168211979,4.490777866880514,1.00352868057199
228,2019-12-09,1267000.0,0.0,23518,7420,8420,-1000,14296,12833,1463,-463,1802,2265,7.662216174844799,1.7222459606163651,9.630920996683392,5.140143129802878
229,2019-12-06,1267000.0,18000.0,16278,5432,6309,-877,10424,7572,2852,-1975,422,2397,2.5924560756849733,-5.069760099159826,14.725396240324365,5.094475243640973
230,2019-12-05,1249000.0,-11000.0,19348,8315,5857,2458,8038,12610,-4572,2114,2995,881,15.47963613810213,12.887180062417157,4.553442216249741,-10.171954024074623
231,2019-12-04,1260000.0,-6000.0,17301,7301,7256,45,8352,8515,-163,118,1648,1530,9.525460956014104,-5.954175182088026,8.843419455522803,4.289977239273061
232,2019-12-03,1266000.0,8000.0,17348,6651,9547,-2896,9341,6933,2408,488,1356,868,7.816462992852202,-1.7089979631619023,5.003458611943739,-3.839960843579063
233,2019-12-02,1258000.0,-7000.0,25534,9955,7529,2426,12922,16725,-3803,1377,2657,1280,10.405733531761573,2.5892705389093713,5.0129239445445295,0.009465332600790077
234,2019-11-29,1265000.0,-25000.0,30107,12692,10908,1784,14381,14158,223,-2007,3034,5041,10.077390640050487,-0.32834289171108644,16.74361444182416,11.730690497279632
235,2019-11-28,1290000.0,14000.0,22331,11598,8345,3253,9860,6184,3676,-6929,873,7802,3.909363664860508,-6.168026975189979,34.937978594778556,18.194364152954396
236,2019-11-27,1276000.0,1000.0,18555,7161,6462,699,10754,8420,2334,-3033,640,3673,3.4492050660199407,-0.4601585988405672,19.795203449205065,-15.142775145573491
237,2019-11-26,1275000.0,4000.0,62248,14337,8090,6247,46942,48783,-1841,-4406,969,5375,1.5566765197275414,-1.8925285462923993,8.634815576404062,-11.160387872801003
238,2019-11-25,1271000.0,10000.0,32800,13128,6755,6373,18773,17126,1647,-8020,899,8919,2.7408536585365852,1.1841771388090438,27.192073170731707,18.557257594327645
239,2019-11-22,1261000.0,28000.0,39159,12435,8787,3648,24810,12496,12314,-15962,1914,17876,4.88776526469011,2.1469116061535245,45.64978676677136,18.457713596039657
240,2019-11-21,1233000.0,20000.0,42375,15347,10048,5299,26276,22537,3739,-9038,752,9790,1.7746312684365784,-3.1131339962535316,23.103244837758112,-22.54654192901325
241,2019-11-20,1213000.0,-2000.0,30605,10441,9631,810,17638,18674,-1036,226,2526,2300,8.25355334095736,6.478922072520782,7.515111909818657,-15.588132927939455
242,2019-11-19,1215000.0,-11000.0,31359,12586,12343,243,12989,16965,-3976,3733,5784,2051,18.444465703625752,10.190912362668392,6.540387129691635,-0.9747247801270218
243,2019-11-18,1226000.0,-7000.0,25243,10075,8974,1101,10835,15238,-4403,3302,4333,1031,17.165154696351465,-1.2793110072742877,4.084300598185635,-2.456086531506
244,2019-11-15,1233000.0,2000.0,23087,14089,6006,8083,8109,14421,-6312,-1771,889,2660,3.8506518820115216,-13.314502814339942,11.52163555247542,7.437334954289785
245,2019-11-14,1231000.0,21000.0,45395,19395,17099,2296,24098,22056,2042,-4338,1902,6240,4.189888754268091,0.33923687225656973,13.746007269523075,2.2243717170476547
246,2019-11-13,1210000.0,-17000.0,24081,6840,7592,-752,8294,13692,-5398,6150,8947,2797,37.15377268385864,32.96388392959055,11.614966155890537,-2.131041113632538
247,2019-11-12,1227000.0,11000.0,21019,7371,7500,-129,10493,11404,-911,1040,3155,2115,15.010228840572815,-22.143543843285826,10.062324563490176,-1.5526415924003611
248,2019-11-11,1216000.0,-37000.0,51084,13571,11646,1925,19141,37369,-18228,16303,18372,2069,35.96429410382898,20.95406526325617,4.050191840889515,-6.0121327226006605
249,합계,,,10317953,3251955,3263787,-11832,5011780,4946464,65316,-53484,2054218,2107702,19.909162214636954,-16.05513188919203,20.427520846431456,16.37732900554194
