,날짜,종가,대비,거래량,기관 매수,기관 매도,기관 순매수,외국인 매수,외국인 매도,외국인 순매수,개인 순매수,개인 매수,개인 매도,개인매수비율(%),개인매수비율증가(%p),개인매도비율(%),개인매도비율증가(%p)
0,2020-11-11,86800.0,900.0,960361,227702,230372,-2670,326591,353667,-27076,29746,406068,376322,42.2828498866572,,39.18547296277129,
1,2020-11-10,85900.0,-1400.0,898189,98093,520892,-422799,167241,117701,49540,373259,632855,259596,70.45900139057592,28.176151503918717,28.90215756371989,-10.283315399051403
2,2020-11-09,87300.0,200.0,586050,134698,230406,-95708,107707,101321,6386,89322,343645,254323,58.637488268919036,-11.821513121656885,43.39612661035748,14.493969046637588
3,2020-11-06,87100.0,600.0,707090,137305,222207,-84902,223806,90793,133013,-48111,345979,394090,48.92998062481438,-9.707507644104659,55.73406497051294,12.337938360155462
4,2020-11-05,86500.0,400.0,754241,121867,423509,-301642,94960,106327,-11367,313009,537414,224405,71.25229203928187,22.322311414467492,29.752426611653306,-25.981638358859634
5,2020-11-04,86100.0,-200.0,602908,172933,290730,-117797,126020,125867,153,117644,303955,186311,50.41482282537303,-20.83746921390884,30.902061342692416,1.1496347310391108
6,2020-11-03,86300.0,800.0,409909,156615,132446,24169,63791,52395,11396,-35565,189503,225068,46.230504819362345,-4.184318006010685,54.906820782173604,24.004759439481187
7,2020-11-02,85500.0,1500.0,510392,155044,171043,-15999,126171,34417,91754,-75755,229177,304932,44.90215363877177,-1.3283511805905732,59.7446668443079,4.837846062134297
8,2020-10-30,84000.0,-3200.0,981485,97529,297793,-200264,197937,194765,3172,197092,686019,488927,69.89602490104281,24.993871262271036,49.815025191419124,-9.929641652888776
9,2020-10-29,87200.0,-2800.0,786668,88682,266910,-178228,67833,276150,-208317,386545,630153,243608,80.10405914566246,10.208034244619654,30.96706615751499,-18.847959033904136
10,2020-10-28,90000.0,600.0,375683,84419,136598,-52179,189494,85681,103813,-51634,101770,153404,27.089327970656115,-53.01473117500635,40.83336216970158,9.866296012186591
11,2020-10-27,89400.0,300.0,523862,120429,213295,-92866,239962,106470,133492,-40626,163471,204097,31.204973828985494,4.11564585832938,38.96006963666004,-1.8732925330415426
12,2020-10-26,89100.0,-500.0,397433,58782,176104,-117322,192994,54283,138711,-21389,145657,167046,36.64944783145838,5.444474002472887,42.03123545352299,3.071165816862951
13,2020-10-23,89600.0,1200.0,453141,81570,104443,-22873,243517,80136,163381,-140508,128054,268562,28.259195261519043,-8.390252569939339,59.26676244259513,17.23552698907214
14,2020-10-22,88400.0,-2000.0,598631,61032,163954,-102922,90287,162995,-72708,175630,447312,271682,74.7224918188333,46.463296557314266,45.38388422918292,-13.882878213412212
15,2020-10-21,90400.0,-300.0,502901,95328,234823,-139495,208219,109819,98400,41095,199354,158259,39.64080405487363,-35.08168776395968,31.469215611024836,-13.914668618158082
16,2020-10-20,90700.0,1600.0,498432,155571,109207,46364,132363,56622,75741,-122105,210498,332603,42.23203967642527,2.5912356215516468,66.72986485618901,35.260649245164174
17,2020-10-19,89100.0,-800.0,487840,131845,176204,-44359,102685,106597,-3912,48271,253310,205039,51.92481141357822,9.692771737152945,42.029968842243356,-24.699896013945654
18,2020-10-16,89900.0,-1500.0,749853,105345,204723,-99378,126294,94888,31406,67972,518214,450242,69.10874531408156,17.18393390050334,60.044035297585,18.01406645534164
19,2020-10-15,91400.0,0.0,678538,138792,221875,-83083,237421,98953,138468,-55385,302325,357710,44.555352832118466,-24.553392481963094,52.71775493782221,-7.326280359762791
20,2020-10-14,91400.0,-300.0,847948,145916,286077,-140161,233661,209185,24476,115685,468371,352686,55.23581634722884,10.680463515110375,41.592880695514346,-11.124874242307861
21,2020-10-13,91700.0,-200.0,1015570,183145,332429,-149284,222436,108736,113700,35584,609989,574405,60.06370806542138,4.827891718192539,56.55986293411581,14.966982238601467
22,2020-10-12,91900.0,-1400.0,1139080,91128,370907,-279779,183841,257672,-73831,353610,864111,510501,75.86043122519929,15.796723159777912,44.81695754468518,-11.742905389430632
23,2020-10-08,93300.0,-2800.0,2181852,362224,793552,-431328,355135,347626,7509,423819,1464493,1040674,67.12155544922386,-8.73887577597543,47.696819032638324,2.879861487953143
24,2020-10-07,96100.0,1700.0,1263545,315330,264567,50763,464674,302556,162118,-212881,483541,696422,38.268601434851945,-28.852954014371917,55.1165174172665,7.419698384628177
25,2020-10-06,94400.0,2300.0,2733167,517620,599783,-82163,703876,269804,434072,-351909,1511671,1863580,55.308402303993866,17.03980086914192,68.18390533765408,13.067387920387581
26,2020-10-05,92100.0,400.0,1007727,186363,302059,-115696,452195,307831,144364,-28668,369169,397837,36.63383039255672,-18.67457191143715,39.478648483170545,-28.705256854483537
27,2020-09-29,91700.0,0.0,808542,158547,136412,22135,292357,253973,38384,-60519,357638,418157,44.232457930447644,7.598627537890927,51.717412329848045,12.2387638466775
28,2020-09-28,91700.0,-1200.0,905918,195510,285272,-89762,188274,191387,-3113,92875,522134,429259,57.63590082104562,13.403442890597972,47.38386918021278,-4.333543149635268
29,2020-09-25,92900.0,3400.0,1625943,554999,280100,274899,376890,189412,187478,-462377,694054,1156431,42.68624422873373,-14.94965659231189,71.12371097879814,23.739841798585367
30,2020-09-24,89500.0,-1700.0,1150871,461461,310539,150922,225442,341006,-115564,-35358,463968,499326,40.31450961923621,-2.3717346094975156,43.38679139538662,-27.73691958341152
31,2020-09-23,91200.0,2300.0,1121711,380964,325952,55012,377624,209150,168474,-223486,363123,586609,32.37224204808547,-7.942267571150744,52.295912226946164,8.909120831559541
32,2020-09-22,88900.0,-2000.0,1054942,156623,366137,-209514,337702,311847,25855,183659,560617,376958,53.141973681965446,20.769731633879978,35.732580558931204,-16.56333166801496
33,2020-09-21,90900.0,1000.0,1050515,279686,389868,-110182,221416,110478,110938,-756,549413,550169,52.29939601052816,-0.842577671437283,52.37136071355478,16.638780154623575
34,2020-09-18,89900.0,-700.0,931059,204413,329501,-125088,276960,289058,-12098,137186,449686,312500,48.29833555123789,-4.001060459290272,33.563930964632746,-18.807429748922033
35,2020-09-17,90600.0,0.0,870174,279886,239928,39958,107211,147625,-40414,456,483077,482621,55.51498895623174,7.216653404993849,55.46258564379079,21.898654679158042
36,2020-09-16,90600.0,-1200.0,815205,164829,236297,-71468,147109,143277,3832,67636,503267,435631,61.735023705693656,6.220034749461917,53.438214927533565,-2.0243707162572235
37,2020-09-15,91800.0,-300.0,952767,190231,296051,-105820,336880,172930,163950,-58130,425656,483786,44.67577067635634,-17.059253029337313,50.776947564304805,-2.6612673632287596
38,2020-09-14,92100.0,-300.0,1226790,280507,371640,-91133,178587,236545,-57958,149091,767696,618605,62.577621271774305,17.90185059541796,50.424685561506045,-0.35226200279875997
39,2020-09-11,92400.0,-800.0,1507008,462990,320410,142580,99524,425104,-325580,183000,944494,761494,62.673456278931496,0.0958350071571914,50.53018962075848,0.10550405925243211
40,2020-09-10,93200.0,3000.0,2880767,916985,564324,352661,403330,362947,40383,-393044,1560452,1953496,54.16793513671879,-8.505521142212707,67.81166265789632,17.281473037137843
41,2020-09-09,90200.0,4400.0,3555936,1166580,578593,587987,748053,258353,489700,-1077687,1641303,2718990,46.156708107232525,-8.011227029486264,76.46341216489836,8.651749507002037
42,2020-09-08,85800.0,2000.0,1367597,474367,246490,227877,147388,209678,-62290,-165587,745842,911429,54.53668003074005,8.379971923507526,66.64455976431654,-9.818852400581818
43,2020-09-07,83800.0,-200.0,629528,106680,225949,-119269,102542,61742,40800,78469,420306,341837,66.76525905122568,12.228579020485633,54.30052356686279,-12.344036197453747
44,2020-09-04,84000.0,-1700.0,974597,91798,418464,-326666,207288,92366,114922,211744,675511,463767,69.31182837624166,2.54656932501598,47.58551483331059,-6.715008733552203
45,2020-09-03,85700.0,-800.0,764553,135125,273276,-138151,117053,106569,10484,127667,512375,384708,67.01628271682931,-2.2955456594123547,50.318028965944805,2.732514132634215
46,2020-09-02,86500.0,-1200.0,1170481,205079,355396,-150317,89209,312496,-223287,373604,876193,502589,74.85751584177787,7.841233124948559,42.93867222107834,-7.379356744866463
47,2020-09-01,87700.0,3500.0,1133236,455949,222247,233702,129058,201957,-72899,-160803,548229,709032,48.37730181533237,-26.480214026445495,62.56702046175731,19.628348240678967
48,2020-08-31,84200.0,-1700.0,1388783,379875,262841,117034,349285,671244,-321959,204925,659623,454698,47.4964771314165,-0.8808246839158755,32.74075215494429,-29.82626830681302
49,2020-08-28,85900.0,-300.0,954228,233627,344481,-110854,142115,127004,15111,95743,578486,482743,60.62345686775068,13.126979736334185,50.589900946105125,17.849148791160836
50,2020-08-27,86200.0,-1700.0,1330067,207589,553814,-346225,356998,71547,285451,60774,765480,704706,57.551987982560284,-3.0714688851903986,52.98274447828568,2.3928435321805566
51,2020-08-26,87900.0,-2400.0,1571474,248481,669513,-421032,261943,265326,-3383,424415,1061050,636635,67.51941171155234,9.967423728992053,40.511965199551504,-12.470779278734177
52,2020-08-25,90300.0,-300.0,1161120,411053,399800,11253,147100,143489,3611,-14864,602967,617831,51.92977470028938,-15.589637011262958,53.20991801019706,12.697952810645553
53,2020-08-24,90600.0,300.0,1265081,596727,370404,226323,111555,208042,-96487,-129836,556799,686635,44.01291300715132,-7.91686169313806,54.275971261919196,1.0660532517221384
54,2020-08-21,90300.0,5400.0,2978055,1033499,565093,468406,472936,149379,323557,-791963,1471620,2263583,49.415474193727114,5.402561186575795,76.0087708252534,21.732799563334197
55,2020-08-20,84900.0,-100.0,1424255,656533,515443,141090,161773,88594,73179,-214269,605949,820218,42.5449796560307,-6.870494537696416,57.58926596711965,-18.41950485813374
56,2020-08-19,85000.0,1000.0,1316003,388994,384861,4133,333362,123011,210351,-214484,593647,808131,45.10985157328668,2.564871917255985,61.40799071126738,3.8187247441477297
57,2020-08-18,84000.0,-4700.0,1462971,419995,423322,-3327,252832,188799,64033,-60706,790144,850850,54.00954632730246,8.899694754015776,58.15904758194114,-3.2489431293262427
58,2020-08-14,88700.0,1700.0,1669303,584232,504675,79557,178582,94914,83668,-163225,906489,1069714,54.30344281415657,0.2938964868541092,64.08147592138755,5.922428339446412
59,2020-08-13,87000.0,-300.0,1950559,617840,606589,11251,234650,178761,55889,-67140,1098069,1165209,56.29509284261589,1.9916500284593184,59.73718303317151,-4.344292888216039
60,2020-08-12,87300.0,4300.0,2704977,750319,557570,192749,558954,266103,292851,-485600,1395704,1881304,51.597629111079314,-4.697463731536573,69.54972260392603,9.812539570754517
61,2020-08-11,83000.0,-2700.0,1684857,411404,515471,-104067,169138,281422,-112284,216351,1104315,887964,65.54354464503515,13.94591553395584,52.70263292374368,-16.84708968018235
62,2020-08-10,85700.0,8500.0,3706582,1317890,716245,601645,540136,202952,337184,-938829,1848556,2787385,49.87225427631171,-15.671290368723447,75.20095333112825,22.49832040738457
63,2020-08-07,77200.0,0.0,759800,214036,321842,-107806,184903,90916,93987,13819,360861,347042,47.49420900236904,-2.378045273942668,45.675440905501446,-29.5255124256268
64,2020-08-06,77200.0,-1100.0,899941,336229,237715,98514,95407,111530,-16123,-82391,468305,550696,52.03730022301462,4.543091220645579,61.192455949890046,15.5170150443886
65,2020-08-05,78300.0,400.0,1197933,310822,303564,7258,361384,142881,218503,-225761,525727,751488,43.88617727368726,-8.151122949327359,62.73205596640212,1.5396000165120753
66,2020-08-04,77900.0,3900.0,1738014,580155,326724,253431,430969,125311,305658,-559089,726890,1285979,41.82302328980089,-2.063153983886373,73.99129120939187,11.259235242989753
67,2020-08-03,74000.0,3300.0,1183563,299974,237338,62636,426263,177106,249157,-311793,457326,769119,38.63976822526558,-3.1832550645353095,64.98335956767828,-9.007931641713597
68,2020-07-31,70700.0,-1400.0,851076,152525,362507,-209982,158604,180359,-21755,231737,539947,308210,63.44286526702668,24.803097041761106,36.21415713755293,-28.769202430125347
69,2020-07-30,72100.0,100.0,735701,155457,218384,-62927,132004,221353,-89349,152276,448240,295964,60.92692547651831,-2.5159397905083694,40.22884296745553,4.0146858299025965
70,2020-07-29,72000.0,-500.0,804210,146302,281040,-134738,224524,134004,90520,44218,433384,389166,53.889406995685206,-7.037518480833107,48.39109187898683,8.1622489115313
71,2020-07-28,72500.0,-1100.0,975596,149805,372746,-222941,243555,157637,85918,137023,582236,445213,59.68003148844399,5.790624492758781,45.63497595316094,-2.7561159258258883
72,2020-07-27,73600.0,-500.0,568984,131813,113423,18390,129167,138617,-9450,-8940,308004,316944,54.13227788479114,-5.5477536036528505,55.70349957116545,10.068523618004512
73,2020-07-24,74100.0,0.0,698830,194875,254300,-59425,251459,94318,157141,-97716,252496,350212,36.13124794299043,-18.00102994180071,50.11404776555099,-5.589451805614459
74,2020-07-23,74100.0,-900.0,759138,106726,205993,-99267,266199,101217,164982,-65715,386213,451928,50.87520319098767,14.743955247997242,59.53173204344928,9.417684277898289
75,2020-07-22,75000.0,100.0,801570,110716,257631,-146915,374287,120434,253853,-106938,316567,423505,39.493369262821716,-11.381833928165953,52.834437416569976,-6.697294626879305
76,2020-07-21,74900.0,-1100.0,912127,145842,268554,-122712,357043,194168,162875,-40163,409242,449405,44.86677842011036,5.373409157288641,49.270002971077496,-3.5644344454924806
77,2020-07-20,76000.0,300.0,901831,190190,274213,-84023,329267,105845,223422,-139399,382374,521773,42.39974008433953,-2.4670383357708303,57.85707078155442,8.587067810476924
78,2020-07-17,75700.0,1200.0,1266762,374644,244004,130640,288612,210248,78364,-209004,603506,812510,47.64162486718105,5.241884782841524,64.14069888424187,6.283628102687452
79,2020-07-16,74500.0,-400.0,1184023,296244,258167,38077,276786,153160,123626,-161703,610993,772696,51.60313608772803,3.9615112205469813,65.26021876264227,1.1195198784003964
80,2020-07-15,74900.0,4100.0,2504840,582992,366488,216504,900741,172572,728169,-944673,1021107,1965780,40.765358266396255,-10.837777821331777,78.47926414461602,13.219045381973757
81,2020-07-14,70800.0,2300.0,1780194,482750,322490,160260,452429,144105,308324,-468584,845015,1313599,47.467579376180346,6.702221109784091,73.78965438598264,-4.689609758633381
82,2020-07-13,68500.0,300.0,569857,168407,132770,35637,140478,58327,82151,-117788,260972,378760,45.79605058813001,-1.6715287880503382,66.46579755973868,-7.3238568262439685
83,2020-07-10,68200.0,500.0,781290,290381,249536,40845,264155,109768,154387,-195232,226754,421986,29.02302602106772,-16.773024567062286,54.01144261413816,-12.454354945600514
84,2020-07-09,67700.0,1300.0,984866,286320,277139,9181,421459,225153,196306,-205487,277087,482574,28.134487331271462,-0.8885386897962597,48.998950110979564,-5.012492503158597
85,2020-07-08,66400.0,900.0,1111546,436000,363358,72642,212256,161686,50570,-123212,463290,586502,41.67978653155155,13.545299200280088,52.76452796375498,3.765577852775415
86,2020-07-07,65500.0,-2600.0,1720050,567138,586353,-19215,331799,253810,77989,-58774,821113,879887,47.73774018197145,6.057953650419904,51.15473387401529,-1.6097940897396867
87,2020-07-06,68100.0,3100.0,1461414,611340,238308,373032,237800,95543,142257,-515289,612274,1127563,41.895999354050254,-5.8417408279212,77.15561777839818,26.00088390438289
88,2020-07-03,65000.0,400.0,494161,142245,144100,-1855,44337,169598,-125261,127116,307579,180463,62.24266989908147,20.346670545031216,36.519069695908826,-40.636548082489355
89,2020-07-02,64600.0,200.0,451291,111986,163201,-51215,179013,165843,13170,38045,160292,122247,35.51854568338389,-26.72412421569758,27.08828671522366,-9.430782980685166
90,2020-07-01,64400.0,1200.0,564319,272725,134885,137840,56349,125836,-69487,-68353,235245,303598,41.686528364276235,6.167982680892344,53.799003754968375,26.710717039744715
91,2020-06-30,63200.0,-300.0,648411,151363,198861,-47498,214875,266412,-51537,99035,282173,183138,43.517614599382185,1.8310862351059498,28.244122940542344,-25.55488081442603
92,2020-06-29,63500.0,-1200.0,756841,210571,190431,20140,195287,159299,35988,-56128,350983,407111,46.37473392694106,2.857119327558877,53.79082264306505,25.546699702522705
93,2020-06-26,64700.0,0.0,528872,102782,162347,-59565,129046,104277,24769,34796,297044,262248,56.16557503516919,9.790841108228129,49.586289310078804,-4.204533332986244
94,2020-06-25,64700.0,-2300.0,798688,175257,301425,-126168,87281,129010,-41729,167897,536150,368253,67.12884129973156,10.963266264562371,46.10724087503505,-3.479048435043751
95,2020-06-24,67000.0,400.0,622511,177964,123704,54260,122042,168565,-46523,-7737,322505,330242,51.80711666139233,-15.321724638339234,53.04998626530294,6.942745390267888
96,2020-06-23,66600.0,-900.0,849668,304053,277214,26839,107329,141477,-34148,7309,438286,430977,51.58320661717283,-0.223910044219501,50.72298827306666,-2.3269979922362793
97,2020-06-22,67500.0,-1300.0,632910,152446,173618,-21172,139311,146864,-7553,28725,341153,312428,53.90229258504369,2.319085967870862,49.36373260021172,-1.3592556728549425
98,2020-06-19,68800.0,1000.0,861053,284388,205411,78977,230590,181594,48996,-127973,346075,474048,40.19206715498349,-13.710225430060198,55.05445077132302,5.6907181711113
99,2020-06-18,67800.0,-400.0,946224,274810,187485,87325,189667,198525,-8858,-78467,481747,560214,50.91257461235394,10.720507457370452,59.205219905646025,4.150769134323006
100,2020-06-17,68200.0,3000.0,1576915,777523,318976,458547,232277,200865,31412,-489959,567115,1057074,35.96357444757644,-14.949000164777502,67.03430432204652,7.829084416400498
101,2020-06-16,65200.0,2300.0,1220699,242507,260828,-18321,184036,291765,-107729,126050,794156,668106,65.05747936223426,29.09390491465782,54.73142846844308,-12.302875853603446
102,2020-06-15,62900.0,-4900.0,1545344,452323,239054,213269,218413,324492,-106079,-107190,874608,981798,56.596330655180985,-8.461148707053276,63.53265033545929,8.80122186701621
103,2020-06-12,67800.0,-1200.0,1689624,386297,229318,156979,189086,238651,-49565,-107414,1114241,1221655,65.94609214831229,9.349761493131304,72.30336453554163,8.770714200082345
104,2020-06-11,69000.0,-1100.0,1942350,520292,433958,86334,258801,535839,-277038,190704,1163257,972553,59.889154889695476,-6.056937258616813,50.07094498931707,-22.232419546224563
105,2020-06-10,70100.0,3500.0,2744224,871272,468775,402497,500458,361524,138934,-541431,1372494,1913925,50.01392014646034,-9.875234743235133,69.74375998460766,19.672814995290594
106,2020-06-09,66600.0,2600.0,1897513,567783,310078,257705,304159,230371,73788,-331493,1025571,1357064,54.04816725893314,4.034247112472798,71.51803439554828,1.7742744109406203
107,2020-06-08,64000.0,1000.0,975466,411833,232788,179045,126471,118218,8253,-187298,437162,624460,44.81570859466142,-9.232458664271718,64.01658284348198,-7.5014515520663
108,2020-06-05,63000.0,800.0,860924,326686,253410,73276,186187,109559,76628,-149904,348051,497955,40.42761033494246,-4.388098259718966,57.83960024345936,-6.176982600022626
109,2020-06-04,62200.0,100.0,934862,335568,234483,101085,110480,94470,16010,-117095,488814,605909,52.28728946090438,11.859679125961925,64.81266753809653,6.9730672946371755
110,2020-06-03,62100.0,2100.0,1433963,559624,244346,315278,270304,121932,148372,-463650,604035,1067685,42.12347180506052,-10.163817655843864,74.45694205499026,9.64427451689373
111,2020-06-02,60000.0,800.0,846026,249232,161971,87261,195073,111292,83781,-171042,401721,572763,47.48329247564496,5.3598206705844404,67.70040164250271,-6.756540412487553
112,2020-06-01,59200.0,-100.0,550906,126106,185661,-59555,33684,86934,-53250,112805,391116,278311,70.99505178741927,23.511759311774313,50.518781788544686,-17.181619853958026
113,2020-05-29,59300.0,800.0,900113,250533,268911,-18378,423094,277736,145358,-126980,226486,353466,25.16195188826292,-45.83309989915635,39.26906955015648,-11.249712238388206
114,2020-05-28,58500.0,-1000.0,1094166,305470,329818,-24348,95710,229929,-134219,158567,692986,534419,63.33463112544167,38.17267923717875,48.842588784517154,9.573519234360674
115,2020-05-27,59500.0,2400.0,1707086,415606,298201,117405,487636,85018,402618,-520023,803844,1323867,47.08866454296972,-16.24596658247195,77.55127744003524,28.70868865551808
116,2020-05-26,57100.0,1000.0,674912,224312,105862,118450,132963,103073,29890,-148340,317637,465977,47.06346901521976,-0.02519552774995759,69.04263074297093,-8.508646697064307
117,2020-05-25,56100.0,-200.0,478311,132837,129332,3505,10284,83306,-73022,69517,335190,265673,70.077836386786,23.014367371566244,55.54398707117336,-13.498643671797566
118,2020-05-22,56300.0,-900.0,518452,126720,119162,7558,121303,92720,28583,-36141,270429,306570,52.16085577835556,-17.916980608430443,59.131800050920816,3.5878129797474543
119,2020-05-21,57200.0,-800.0,709139,115273,201200,-85927,73273,194121,-120848,206775,520593,313818,73.41198270014765,21.251126921792086,44.253383328233255,-14.878416722687561
120,2020-05-20,58000.0,-200.0,552137,110719,156740,-46021,124692,129471,-4779,50800,316726,265926,57.36366155501261,-16.048321145135034,48.163046490273246,3.9096631620399904
121,2020-05-19,58200.0,1800.0,1138915,301291,138651,162640,255196,161941,93255,-255895,582428,838323,51.138847060579586,-6.224814494433026,73.60716120167001,25.444114711396765
122,2020-05-18,56400.0,2000.0,1005066,275529,169438,106091,323622,107557,216065,-322156,405915,728071,40.386899964778436,-10.75194709580115,72.44011836038628,-1.167042841283731
123,2020-05-15,54400.0,200.0,504474,160310,164834,-4524,128568,119499,9069,-4545,215596,220141,42.73679119241031,2.349891227631872,43.63772959557876,-28.802388764807517
124,2020-05-14,54200.0,-800.0,593689,175079,220703,-45624,156154,180238,-24084,69708,262456,192748,44.20765754460669,1.4708663521963814,32.46615652302805,-11.171573072550714
125,2020-05-13,55000.0,500.0,577061,212760,186766,25994,171039,159245,11794,-37788,193262,231050,33.49074014705551,-10.716917397551178,40.03909465377144,7.572938130743395
126,2020-05-12,54500.0,0.0,707739,147070,168771,-21701,294969,190038,104931,-83230,265700,348930,37.54208825569878,4.051348108643268,49.302073221908074,9.262978568136631
127,2020-05-11,54500.0,-700.0,536547,80544,164182,-83638,123794,103013,20781,62857,332209,269352,61.916104274182885,24.374016018484106,50.201007553858275,0.8989343319502012
128,2020-05-08,55200.0,500.0,632501,129354,185402,-56048,218950,147800,71150,-15102,284197,299299,44.932260976662484,-16.9838432975204,47.31992518588903,-2.881082367969242
129,2020-05-07,54700.0,-800.0,754248,141984,106194,35790,135902,310306,-174404,138614,476362,337748,63.15721089084757,18.22494991418509,44.77943594149404,-2.5404892443949905
130,2020-05-06,55500.0,300.0,805783,145409,83982,61427,287831,400777,-112946,51519,372543,321024,46.23366340565636,-16.923547485191214,39.84000655263266,-4.9394293888613845
131,2020-05-04,55200.0,300.0,1119161,114292,295456,-181164,535968,224007,311961,-130797,468901,599698,41.89754646561129,-4.336116940045066,53.58460489598905,13.744598343356394
132,2020-04-29,54900.0,1300.0,1017067,162346,142560,19786,270687,128343,142344,-162130,584034,746164,57.42335559014303,15.52580912453174,73.36429163467106,19.77968673868201
133,2020-04-28,53600.0,200.0,712240,125673,192122,-66449,142412,125759,16653,49796,444155,394359,62.360299898910476,4.936944308767444,55.36883634729867,-17.995455287372394
134,2020-04-27,53400.0,800.0,561740,179935,111225,68710,146562,111570,34992,-103702,235243,338945,41.877559013066545,-20.48274088584393,60.338412788834695,4.969576441536027
135,2020-04-24,52600.0,-700.0,529035,153272,216876,-63604,89475,105354,-15879,79483,286288,206805,54.11513415936564,12.237575146299093,39.09098641866795,-21.247426370166743
136,2020-04-23,53300.0,900.0,702412,217407,203936,13471,166690,92662,74028,-87499,318315,405814,45.317420545207085,-8.797713614158553,57.77435465225537,18.683368233587416
137,2020-04-22,52400.0,-200.0,727548,136795,343448,-206653,140414,120674,19740,186913,450339,263426,61.89818403734186,16.58076349213478,36.20737051026187,-21.5669841419935
138,2020-04-21,52600.0,-1200.0,1029388,218896,347540,-128644,140274,122827,17447,111197,670218,559021,65.1083945023645,3.210210465022641,54.30615083913936,18.098780328877496
139,2020-04-20,53800.0,-700.0,809110,154032,239039,-85007,58123,189314,-131191,216198,596955,380757,73.77921419831667,8.670819695952162,47.05874355773628,-7.247407281403085
140,2020-04-17,54500.0,1000.0,1414373,174510,186876,-12366,180236,189497,-9261,21627,1059627,1038000,74.91849745434904,1.1392832560323711,73.38941000711976,26.330666449383486
141,2020-04-16,53500.0,-100.0,788724,115346,125795,-10449,192677,345007,-152330,162779,480701,317922,60.94666828954109,-13.97182916480795,40.308396853652226,-33.08101315346754
142,2020-04-14,53600.0,400.0,922591,382932,167198,215734,140033,441077,-301044,85310,399626,314316,43.315618730293274,-17.631049559247813,34.06883440224325,-6.239562451408979
143,2020-04-13,53200.0,-600.0,626957,134576,211324,-76748,47571,70767,-23196,99944,444810,344866,70.94744934660591,27.631830616312634,55.00632419767225,20.937489795429002
144,2020-04-10,53800.0,-400.0,687486,131514,198745,-67231,31128,96653,-65525,132756,524844,392088,76.34250006545588,5.395050718849973,57.03214320000698,2.0258190023347282
145,2020-04-09,54200.0,900.0,926771,282828,228351,54477,90515,226124,-135609,81132,553428,472296,59.71572265424791,-16.626777411207968,50.96145649788352,-6.07068670212346
146,2020-04-08,53300.0,-1200.0,1593974,306600,443070,-136470,222219,478900,-256681,393151,1065155,672004,66.8238628735475,7.108140219299585,42.159031452206875,-8.802425045676642
147,2020-04-07,54500.0,3400.0,2123508,541826,428578,113248,139706,357166,-217460,104212,1441976,1337764,67.90537167743187,1.0815088038843754,62.997831889496055,20.83880043728918
148,2020-04-06,51100.0,1250.0,868309,237935,121800,116135,144539,175061,-30522,-85613,485835,571448,55.95185584855161,-11.953515828880263,65.81159472031271,2.813762830816657
149,2020-04-03,49850.0,550.0,963015,229583,202211,27372,188130,315521,-127391,100019,545302,445283,56.624455486155455,0.6725996376038452,46.23842826954928,-19.57316645076343
150,2020-04-02,49300.0,1200.0,1071663,427787,238928,188859,239865,390118,-150253,-38606,404011,442617,37.699444694834106,-18.92501079132135,41.301883147967224,-4.936545121582057
151,2020-04-01,48100.0,-100.0,1298461,416014,361389,54625,349134,303791,45343,-99968,533313,633281,41.072700681807156,3.3732559869730494,48.77166122047563,7.469778072508404
152,2020-03-31,48200.0,-300.0,1106424,244399,304299,-59900,296877,466623,-169746,229646,565148,335502,51.078790770988334,10.006090089181178,30.32309494371055,-18.448566276765078
153,2020-03-30,48500.0,-900.0,937027,291545,275508,16037,205829,415198,-209369,193332,439653,246321,46.91999270031707,-4.158798070671267,26.287502921473983,-4.0355920222365675
154,2020-03-27,49400.0,400.0,1110394,391458,327057,64401,110848,331532,-220684,156283,608088,451805,54.763264210721594,7.843271510404527,40.688710493752666,14.401207572278683
155,2020-03-26,49000.0,500.0,1377158,353788,314926,38862,257323,345680,-88357,49495,766047,716552,55.62520785559827,0.8619436448766749,52.03121210492914,11.342501611176473
156,2020-03-25,48500.0,4100.0,1506779,463722,418931,44791,281435,268524,12911,-57702,761622,819324,50.546364131700805,-5.078843723897464,54.37585737523551,2.3446452703063727
157,2020-03-24,44400.0,2550.0,1316623,395941,283847,112094,256173,394521,-138348,26254,664509,638255,50.47071181348039,-0.0756523182204134,48.4766709984559,-5.89918637677961
158,2020-03-23,41850.0,-3250.0,1186795,312824,409634,-96810,205624,363855,-158231,255041,668347,413306,56.315286127764274,5.844574314283882,34.825391074279885,-13.651279924176016
159,2020-03-20,45100.0,1450.0,1539670,409615,325414,84201,313351,622114,-308763,224562,816704,592142,53.04409386426961,-3.2711922634946617,38.45902043944482,3.6336293651649356
160,2020-03-19,43650.0,-4350.0,1601945,472296,437694,34602,429478,512663,-83185,48583,700171,651588,43.70755550284186,-9.336538361427749,40.67480469054805,2.21578425110323
161,2020-03-18,48000.0,-1450.0,886739,260658,249835,10823,184108,302526,-118418,107595,441973,334378,49.84251284763611,6.134957344794245,37.70872827291909,-2.966076417628962
162,2020-03-17,49450.0,-950.0,1004008,271292,269882,1410,316979,352971,-35992,34582,415737,381155,41.40773778694991,-8.4347750606862,37.963342921570344,0.2546146486512555
163,2020-03-16,50400.0,-2100.0,948845,194928,304573,-109645,220487,314025,-93538,203183,533430,330247,56.21887663422371,14.811138847273803,34.805157849806875,-3.1581850717634694
164,2020-03-13,52500.0,-3000.0,1968749,527532,706966,-179434,747875,715968,31907,147527,693342,545815,35.21738931676918,-21.001487317454533,27.723950589943158,-7.081207259863717
165,2020-03-12,55500.0,-3500.0,1649095,596438,390037,206401,330547,881378,-550831,344430,722110,377680,43.788259621186164,8.570870304416985,22.902258511486604,-4.821692078456554
166,2020-03-11,59000.0,-1000.0,938290,255388,252225,3163,296739,482524,-185785,182622,386163,203541,41.156039177652964,-2.6322204435331997,21.69276023404278,-1.2094982774438243
167,2020-03-10,60000.0,2200.0,1500440,529333,448895,80438,605679,438526,167153,-247591,365428,613019,24.35472261469969,-16.801316562953275,40.85594892164965,19.16318868760687
168,2020-03-09,57800.0,-2500.0,1001568,351097,219172,131925,150001,473920,-323919,191994,500470,308476,49.968649158120066,25.613926543420376,30.7993066871146,-10.056642234535047
169,2020-03-06,60300.0,-1200.0,542438,196326,222065,-25739,105768,199777,-94009,119748,240344,120596,44.30810525811245,-5.660543900007617,22.232218244297044,-8.567088442817557
170,2020-03-05,61500.0,900.0,573595,179508,218224,-38716,147371,161011,-13640,52356,246716,194360,43.01222988345435,-1.2958753746580953,33.88453525571178,11.652317011414738
171,2020-03-04,60600.0,400.0,520867,128206,164929,-36723,179817,192382,-12565,49288,212844,163556,40.86340658939806,-2.1488232940562924,31.400722257313284,-2.4838129983984985
172,2020-03-03,60200.0,100.0,587763,129526,261323,-131797,80161,149195,-69034,200831,378076,177245,64.32456619419732,23.461159604799256,30.15586214171358,-1.2448601155997032
173,2020-03-02,60100.0,-300.0,711979,240773,260950,-20177,115743,251075,-135332,155509,355463,199954,49.926051189712055,-14.398515004485262,28.084255294046596,-2.0716068476669847
174,2020-02-28,60400.0,-2000.0,932828,407022,239339,167683,166864,308650,-141786,-25897,358942,384839,38.47890500713958,-11.447146182572475,41.25508668264675,13.170831388600153
175,2020-02-27,62400.0,-900.0,524379,284116,226854,57262,52524,162641,-110117,52855,187739,134884,35.80215836255838,-2.6767466445812005,25.72261665703623,-15.532470025610518
176,2020-02-26,63300.0,300.0,607215,245306,227691,17615,207478,148846,58632,-76247,154431,230678,25.43267211778365,-10.36948624477473,37.989509481814515,12.266892824778285
177,2020-02-25,63000.0,-300.0,956415,266771,226673,40098,250567,542797,-292230,252132,439077,186945,45.90862753093584,20.47595541315219,19.546431204027538,-18.443078277786977
178,2020-02-24,63300.0,-2800.0,874557,383200,223592,159608,76821,307981,-231160,71552,414536,342984,47.39954056739584,1.4909130364600003,39.2180269553614,19.671595751333864
179,2020-02-21,66100.0,-1100.0,531902,206238,223102,-16864,95700,137342,-41642,58506,229964,171458,43.23427999894717,-4.165260568448666,32.23488537362146,-6.983141581739943
180,2020-02-20,67200.0,-1600.0,677402,165255,297390,-132135,139854,164779,-24925,157060,372293,215233,54.95894609109509,11.72466609214792,31.77330447799091,-0.4615808956305507
181,2020-02-19,68800.0,-100.0,636116,213219,156117,57102,214451,247097,-32646,-24456,208446,232902,32.76855164781266,-22.190394443282436,36.61313345364682,4.839828975655909
182,2020-02-18,68900.0,1900.0,1338368,541154,342634,198520,272517,212054,60463,-258983,524697,783680,39.20423979055088,6.435688142738222,58.55489671002295,21.941763256376134
183,2020-02-17,67000.0,0.0,560384,246934,157311,89623,65681,171357,-105676,16053,247769,231716,44.21414601416172,5.009906223610841,41.349503197807216,-17.205393512215736
184,2020-02-14,67000.0,-100.0,354348,119883,183597,-63714,98393,57987,40406,23308,136072,112764,38.40066826961067,-5.813477744551051,31.822953706525787,-9.526549491281429
185,2020-02-13,67100.0,-800.0,699540,190023,376816,-186793,255836,152130,103706,83087,253681,170594,36.263973468279154,-2.1366948013315152,24.386596906538582,-7.436356799987205
186,2020-02-12,67900.0,700.0,487071,195878,169460,26418,149672,99337,50335,-76753,141521,218274,29.05551757341332,-7.2084558948658355,44.81358980518241,20.426992898643828
187,2020-02-11,67200.0,200.0,462160,156695,162153,-5458,171597,125657,45940,-40482,133868,174350,28.965726155444,-0.08979141796931955,37.72503029253938,-7.08855951264303
188,2020-02-10,67000.0,-300.0,364246,149877,126366,23511,73404,126509,-53105,29594,140965,111371,38.700493622441975,9.734767466997976,30.575764730429434,-7.149265562109946
189,2020-02-07,67300.0,500.0,519466,165621,215925,-50304,220767,58631,162136,-111832,133078,244910,25.618231029557275,-13.0822625928847,47.146492744472205,16.57072801404277
190,2020-02-06,66800.0,1600.0,635295,192943,237950,-45007,207755,140284,67471,-22464,234597,257061,36.92725426770241,11.309023238145134,40.46324935659811,-6.683243387874093
191,2020-02-05,65200.0,100.0,657342,186462,272911,-86449,225149,211308,13841,72608,245731,173123,37.38251929741291,0.4552650297105032,26.33682314533378,-14.12642621126433
192,2020-02-04,65100.0,200.0,716163,187115,344819,-157704,204756,262948,-58192,215896,324292,108396,45.28187018876987,7.89935089135696,15.135660457186423,-11.201162688147358
193,2020-02-03,64900.0,-1000.0,797729,294998,254957,40041,236999,364071,-127072,87031,265732,178701,33.31106177661838,-11.970808412151491,22.40121645320654,7.265555996020117
194,2020-01-31,65900.0,-1300.0,697360,209059,218966,-9907,155834,306329,-150495,160402,332467,172065,47.67508890673397,14.364027130115588,24.673769645520245,2.272553192313705
195,2020-01-30,67200.0,0.0,549972,181564,185472,-3908,171571,191968,-20397,24305,196837,172532,35.79036750961867,-11.8847213971153,31.37105161717324,6.697281971652995
196,2020-01-29,67200.0,100.0,585990,261082,222386,38696,108065,251234,-143169,104473,216843,112370,37.0045563917473,1.2141888821286315,19.176095155207427,-12.194956461965813
197,2020-01-28,67100.0,-1900.0,729302,335301,252273,83028,60852,205247,-144395,61367,333149,271782,45.68052740839871,8.67597101665141,37.266043422340815,18.089948267133387
198,2020-01-23,69000.0,-1400.0,604024,188541,250345,-61804,87948,251206,-163258,225062,327535,102473,54.225494351217826,8.544966942819116,16.96505436870058,-20.300989053640233
199,2020-01-22,70400.0,300.0,546215,191653,126944,64709,129572,203193,-73621,8912,224990,216078,41.19073991010866,-13.034754441109165,39.55914795456002,22.594093585859437
200,2020-01-21,70100.0,-1100.0,379059,110167,140738,-30571,73098,90771,-17673,48244,195794,147550,51.65264510274126,10.4619051926326,38.92533879950087,-0.6338091550591471
201,2020-01-20,71200.0,2000.0,894609,269546,179618,89928,370774,121773,249001,-338929,254289,593218,28.42459666737088,-23.22804843537038,66.31030986721574,27.384971067714865
202,2020-01-17,69200.0,-700.0,464204,120283,210040,-89757,116574,105391,11183,78574,227347,148773,48.97566587103946,20.55106920366858,32.04905601847464,-34.2612538487411
203,2020-01-16,69900.0,300.0,440562,116680,144851,-28171,181398,112344,69054,-40883,142484,183367,32.34141846096576,-16.634247410073698,41.62115661359809,9.572100595123452
204,2020-01-15,69600.0,1300.0,698052,204645,163254,41391,279586,193648,85938,-127329,213821,341150,30.631099115825183,-1.7103193451405794,48.87171729326755,7.250560679669462
205,2020-01-14,68300.0,1700.0,1081428,381049,347752,33297,250999,240178,10821,-44118,449380,493498,41.554315220245826,10.923216104420643,45.63392107472712,-3.2377962185404314
206,2020-01-13,66600.0,-200.0,600906,164831,259737,-94906,69176,202828,-133652,228558,366899,138341,61.057636302516535,19.50332108227071,23.022070007621824,-22.611851067105295
207,2020-01-10,66800.0,200.0,797710,209509,290128,-80619,189501,288439,-98938,179557,398700,219143,49.98056937984982,-11.077066922666717,27.47151220368304,4.4494421960612165
208,2020-01-09,66600.0,-900.0,1565867,411415,650378,-238963,231947,584492,-352545,591508,922505,330997,58.91336875992661,8.932799380076794,21.13825759148127,-6.33325461220177
209,2020-01-08,67500.0,-2800.0,937438,226543,445679,-219136,305120,227983,77137,141999,405775,263776,43.28552928300325,-15.627839476923363,28.13796752425227,6.999709932771001
210,2020-01-07,70300.0,400.0,265311,77886,115138,-37252,105048,53936,51112,-13860,82377,96237,31.049221479697415,-12.236307803305834,36.273279283557784,8.135311759305512
211,2020-01-06,69900.0,-1200.0,337026,130010,146783,-16773,65264,49875,15389,1384,141752,140368,42.05966305270217,11.010441573004755,41.64901224237892,5.375732958821139
212,2020-01-03,71100.0,100.0,369493,135048,233436,-98388,102228,56591,45637,52751,132217,79466,35.7833571948589,-6.276305857843269,21.506767381249443,-20.14224486112948
213,2020-01-02,71000.0,-1100.0,284758,87761,140782,-53021,53431,66674,-13243,66264,143566,77302,50.416845180820204,14.633487985961303,27.146559534762847,5.639792153513405
214,2019-12-30,72100.0,300.0,283273,64743,53961,10782,160293,153241,7052,-17834,58237,76071,20.558613069371244,-29.85823211144896,26.85430662293971,-0.2922529118231374
215,2019-12-27,71800.0,500.0,498244,127698,178544,-50846,183686,212369,-28683,79529,186860,107331,37.50371304019717,16.945099970825925,21.541854994741534,-5.3124516281981755
216,2019-12-26,71300.0,-600.0,372424,141755,72202,69553,58833,54974,3859,-73412,171836,245248,46.13988357356132,8.636170533364151,65.85182480183876,44.309969807097225
217,2019-12-24,71900.0,-600.0,220741,119619,71529,48090,46492,35492,11000,-59090,54630,113720,24.748460865901666,-21.391422707659654,51.51738915742884,-14.334435644409922
218,2019-12-23,72500.0,0.0,257344,129620,93044,36576,56787,36310,20477,-57053,70937,127990,27.565049117135043,2.8165882512333766,49.734985078338724,-1.7824040790901137
219,2019-12-20,72500.0,0.0,403031,59292,68203,-8911,234589,199710,34879,-25968,109150,135118,27.082283993042715,-0.4827651240923281,33.525460820631665,-16.20952425770706
220,2019-12-19,72500.0,0.0,302037,70530,100947,-30417,166164,72859,93305,-62888,65343,128231,21.634104430914096,-5.448179562128619,42.45539453775531,8.929933717123646
221,2019-12-18,72500.0,100.0,399504,131322,139186,-7864,175607,105805,69802,-61938,92575,154513,23.172483880011214,1.5383794490971177,38.67620849853819,-3.779186039217123
222,2019-12-17,72400.0,400.0,455261,135774,145618,-9844,180954,123187,57767,-47923,138533,186456,30.429358104471945,7.256874224460731,40.9558473051722,2.2796388066340114
223,2019-12-16,72000.0,-200.0,271523,140633,63338,77295,80867,116368,-35501,-41794,50023,91817,18.42311701034535,-12.006241094126594,33.815551537070526,-7.140295768101673
224,2019-12-13,72200.0,500.0,405472,156541,88632,67909,142502,149655,-7153,-60756,106429,167185,26.248174966458844,7.825057956113493,41.23219359166601,7.416642054595485
225,2019-12-12,71700.0,500.0,979009,476645,342579,134066,418059,358294,59765,-193831,84305,278136,8.611258936332558,-17.636916030126287,28.409953330357535,-12.822240261308476
226,2019-12-11,71200.0,0.0,339949,118056,114941,3115,109918,108647,1271,-4386,111975,116361,32.93876434406337,24.327505407730815,34.22895787309273,5.819004542735197
227,2019-12-10,71200.0,2100.0,575566,136342,205783,-69441,367185,48188,318997,-249556,72039,321595,12.51620144344871,-20.422562900614665,55.874565210592706,21.645607337499975
228,2019-12-09,69100.0,-1100.0,436982,121555,183772,-62217,98388,147144,-48756,110973,217039,106066,49.66772086722108,37.15151942377237,24.272395659317773,-31.602169551274933
229,2019-12-06,70200.0,200.0,272392,75395,88864,-13469,130958,113308,17650,-4181,66039,70220,24.244104085288846,-25.423616781932232,25.779024347264233,1.5066286879464599
230,2019-12-05,70000.0,0.0,295956,78457,123394,-44937,140516,103877,36639,8298,76983,68685,26.01163686493938,1.7675327796505336,23.20784170619957,-2.571182641064663
231,2019-12-04,70000.0,-500.0,294889,121278,108805,12473,113491,118206,-4715,-7758,60120,67878,20.387332182617868,-5.624304682321512,23.01815259300957,-0.18968911318999915
232,2019-12-03,70500.0,200.0,217447,90465,76590,13875,101479,39350,62129,-76004,25503,101507,11.728375190276251,-8.658956992341617,46.681260261121096,23.663107668111525
233,2019-12-02,70300.0,400.0,237237,92770,80302,12468,92059,80108,11951,-24419,52408,76827,22.09098917959677,10.36261398932052,32.384071624577956,-14.29718863654314
234,2019-11-29,69900.0,-1100.0,350465,149617,139885,9732,59467,116627,-57160,47428,141381,93953,40.34097556104033,18.24998638144356,26.80809781290571,-5.575973811672245
235,2019-11-28,71000.0,-500.0,259491,106437,91898,14539,16775,54946,-38171,23632,136279,112647,52.517813719936335,12.176838158896004,43.41075413020105,16.602656317295338
236,2019-11-27,71500.0,600.0,292977,105157,106078,-921,104580,50684,53896,-52975,83240,136215,28.41178659075627,-24.106027129180063,46.493410745553405,3.082656615352356
237,2019-11-26,70900.0,-500.0,697121,246028,105921,140107,348968,428926,-79958,-60149,102125,162274,14.649537167866121,-13.76224942289015,23.277738011048296,-23.21567273450511
238,2019-11-25,71400.0,1300.0,380355,182143,129237,52906,120010,95451,24559,-77465,78202,155667,20.56026606722667,5.910728899360549,40.92676578459597,17.649027773547676
239,2019-11-22,70100.0,-300.0,267673,106617,97509,9108,58898,84831,-25933,16825,102158,85333,38.1652239859829,17.604957918756227,31.87956947469487,-9.047196309901103
240,2019-11-21,70400.0,-500.0,475086,175025,120241,54784,159660,163922,-4262,-50522,140401,190923,29.55275465915645,-8.61246932682645,40.18703982015887,8.307470345464004
241,2019-11-20,70900.0,-1000.0,479826,149388,124588,24800,132346,208923,-76577,51777,198092,146315,41.28413216457633,11.731377505419879,30.493345504412016,-9.693694315746857
242,2019-11-19,71900.0,400.0,538536,240143,171428,68715,126482,80545,45937,-114652,171911,286563,31.92191422671836,-9.362217937857967,53.21148446900486,22.718138964592843
243,2019-11-18,71500.0,1000.0,609015,286077,129931,156146,129671,94998,34673,-190819,193267,384086,31.73435793863862,-0.18755628807974034,63.066755334433466,9.855270865428608
244,2019-11-15,70500.0,1500.0,728818,266391,89673,176718,304650,96669,207981,-384699,157777,542476,21.64834018918303,-10.08601774945559,74.43229997063739,11.365544636203921
245,2019-11-14,69000.0,200.0,305427,205130,180635,24495,74252,43867,30385,-54880,26045,80925,8.527405894043422,-13.120934295139609,26.49569291516467,-47.93660705547272
246,2019-11-13,68800.0,-200.0,366473,93131,142073,-48942,168553,139600,28953,19989,104789,84800,28.593920970985586,20.066515076942164,23.139494587595813,-3.3561983275688583
247,2019-11-12,69000.0,-300.0,311635,101195,111605,-10410,110322,118278,-7956,18366,100118,81752,32.12668666869896,3.532765697713373,26.233253646092386,3.0937590584965733
248,2019-11-11,69300.0,-100.0,278287,130811,94311,36500,86010,80914,5096,-41596,61466,103062,22.087269617337498,-10.039417051361461,37.03442848570002,10.801174839607633
249,합계,,,228168613,64750448,63447397,1303051,51872266,48729771,3142495,-4445546,111545899,115991445,48.8874861153668,26.8002164980293,50.8358461205179,13.80141763481788
