,날짜,종가,대비,거래량,기관 매수,기관 매도,기관 순매수,외국인 매수,외국인 매도,외국인 순매수,개인 순매수,개인 매수,개인 매도,개인매수비율(%),개인매수비율증가(%p),개인매도비율(%),개인매도비율증가(%p)
0,2020-11-11,230500.0,3500.0,353850,126903,87741,39162,120928,96434,24494,-63656,106019,169675,29.96156563515614,,47.951109227073616,
1,2020-11-10,227000.0,1500.0,485633,73459,91640,-18181,274424,294782,-20358,38539,137750,99211,28.365041090700178,-1.5965245444559635,20.429213006529622,-27.521896220543994
2,2020-11-09,225500.0,-1500.0,334885,102508,112636,-10128,67153,156161,-89008,99136,165224,66088,49.337533780252926,20.972492689552748,19.734535736148228,-0.6946772703813942
3,2020-11-06,227000.0,4000.0,356362,108490,115981,-7491,149575,69797,79778,-72287,98297,170584,27.583468495518602,-21.754065284734324,47.868178986536165,28.133643250387937
4,2020-11-05,223000.0,4500.0,409377,104209,154336,-50127,170141,147324,22817,27310,135027,107717,32.983533515561454,5.400065020042852,26.312421069087904,-21.55575791744826
5,2020-11-04,218500.0,-500.0,301637,102251,82446,19805,51038,162899,-111861,92056,148348,56292,49.18096917818438,16.197435662622922,18.662166776622232,-7.650254292465672
6,2020-11-03,219000.0,4000.0,396439,127159,107656,19503,150988,216080,-65092,45589,118292,72703,29.83863847905983,-19.342330699124545,18.339013063800483,-0.32315371282174965
7,2020-11-02,215000.0,1000.0,291912,86111,75269,10842,74177,160409,-86232,75390,131624,56234,45.09030118665899,15.25166270759916,19.264024774589604,0.9250117107891214
8,2020-10-30,214000.0,-8500.0,507996,76999,96276,-19277,93217,298776,-205559,224836,337780,112944,66.49264954842164,21.402348361762648,22.23324593107032,2.9692211564807174
9,2020-10-29,222500.0,-7000.0,389701,68829,110243,-41414,27784,197651,-169867,211281,293088,81807,75.2084290263561,8.715779477934461,20.992247902879388,-1.2409980281909334
10,2020-10-28,229500.0,-3000.0,366158,124285,92376,31909,33895,232089,-198194,166285,207978,41693,56.80006991517323,-18.408359111182868,11.386614521599965,-9.605633381279423
11,2020-10-27,232500.0,-1500.0,198183,92687,74085,18602,15235,77966,-62731,44129,90261,46132,45.544269690134875,-11.255800225038357,23.27747586826317,11.890861346663206
12,2020-10-26,234000.0,-4500.0,150976,82226,40666,41560,12490,50233,-37743,-3817,56260,60077,37.264200932598555,-8.28006875753632,39.79241733785502,16.51494146959185
13,2020-10-23,238500.0,0.0,147788,100042,41991,58051,17290,34846,-17556,-40495,30456,70951,20.60789779955071,-16.656303133047846,48.00863398922781,8.21621665137279
14,2020-10-22,238500.0,500.0,186902,106193,68412,37781,35878,69787,-33909,-3872,44831,48703,23.986367187082,3.3784693875312897,26.058041112454656,-21.950592876773154
15,2020-10-21,238000.0,5000.0,207784,97913,66078,31835,72898,38635,34263,-66098,36973,103071,17.7939591113849,-6.192408075697099,49.60487814268664,23.54683703023198
16,2020-10-20,233000.0,500.0,193210,104140,60899,43241,34104,71432,-37328,-5913,54966,60879,28.44883805186067,10.654878940475768,31.50923865224367,-18.095639490442966
17,2020-10-19,232500.0,-2000.0,238800,142368,97668,44700,24225,69336,-45111,411,72207,71796,30.23743718592965,1.7885991340689813,30.065326633165828,-1.4439120190778425
18,2020-10-16,234500.0,0.0,313341,197295,100920,96375,63069,114637,-51568,-44807,52977,97784,16.90713950616102,-13.33029767976863,31.206896001480818,1.1415693683149897
19,2020-10-15,234500.0,4000.0,654059,278628,117878,160750,225879,324530,-98651,-62099,149552,211651,22.865215523370217,5.958076017209198,32.35961893346013,1.1527229319793157
20,2020-10-14,230500.0,-12000.0,860420,239492,176327,63165,110294,337504,-227210,164045,510634,346589,59.34706306222542,36.481847538855206,40.28137421259385,7.92175527913372
21,2020-10-13,242500.0,3000.0,184800,86484,77359,9125,41584,24456,17128,-26253,56732,82985,30.6991341991342,-28.647928863091224,44.90530303030303,4.623928817709178
22,2020-10-12,239500.0,-500.0,189246,94088,86727,7361,42151,51309,-9158,1797,53007,51210,28.009574839098317,-2.689559360035883,27.06001712057322,-17.84528590972981
23,2020-10-08,240000.0,-1000.0,233062,95588,131509,-35921,68825,45945,22880,13041,68649,55608,29.455252250474125,1.445677411375808,23.859745475452883,-3.2002716451203383
24,2020-10-07,241000.0,0.0,179764,115551,71955,43596,15677,57720,-42043,-1553,48536,50089,26.99984424022607,-2.4554080102480533,27.863754700607462,4.004009225154579
25,2020-10-06,241000.0,500.0,181255,87672,88998,-1326,53064,23152,29912,-28586,40519,69105,22.354693663623074,-4.6451505766029975,38.125844804281265,10.262090103673803
26,2020-10-05,240500.0,2500.0,247547,128777,85492,43285,65832,83416,-17584,-25701,52938,78639,21.385029913511374,-0.9696637501116996,31.767300755008137,-6.358544049273128
27,2020-09-29,238000.0,5000.0,225845,102722,63666,39056,85915,65992,19923,-58979,37208,96187,16.47501605083132,-4.910013862680053,42.58982930771104,10.822528552702906
28,2020-09-28,233000.0,2000.0,108166,58278,33955,24323,16171,29217,-13046,-11277,33717,44994,31.171532644268996,14.696516593437675,41.59717471294122,-0.9926545947698244
29,2020-09-25,231000.0,500.0,162365,85719,57011,28708,18644,34457,-15813,-12895,58002,70897,35.72321621039017,4.551683566121174,43.66519878052536,2.0680240675841404
30,2020-09-24,230500.0,-2500.0,237132,86255,74356,11899,83738,52620,31118,-43017,67139,110156,28.312922760319147,-7.410293450071023,46.453452085758144,2.788253305232786
31,2020-09-23,233000.0,-4500.0,352067,126716,135486,-8770,60765,62286,-1521,10291,164586,154295,46.74848821389111,18.43556545357196,43.825465039324904,-2.6279870464332404
32,2020-09-22,237500.0,-3000.0,236983,68523,84495,-15972,70181,36723,33458,-17486,98279,115765,41.470907195874815,-5.277581018016292,48.84949553343489,5.0240304941099865
33,2020-09-21,240500.0,-3500.0,214090,110047,72870,37177,23870,29572,-5702,-31475,80173,111648,37.448269419403054,-4.022637776471761,52.1500303610631,3.300534827628212
34,2020-09-18,244000.0,0.0,220441,71797,68994,2803,97293,76358,20935,-23738,51351,75089,23.29466841467785,-14.153601004725203,34.06308263889204,-18.08694772217106
35,2020-09-17,244000.0,1000.0,182401,68201,70435,-2234,48194,20962,27232,-24998,66006,91004,36.187301604706114,12.892633190028263,49.89227032746531,15.82918768857327
36,2020-09-16,243000.0,-3000.0,214144,72955,103078,-30123,27299,16295,11004,19119,113890,94771,53.18383891213389,16.99653730742778,44.25573445905559,-5.636535868409723
37,2020-09-15,246000.0,-2000.0,242579,93672,122187,-28515,11916,27410,-15494,44009,136991,92982,56.47273671669848,3.2888978045645842,38.33060569958653,-5.925128759469061
38,2020-09-14,248000.0,5000.0,280140,87841,72379,15462,99221,29581,69640,-85102,93078,178180,33.22553009209681,-23.247206624601667,63.60391232954951,25.27330662996298
39,2020-09-11,243000.0,3000.0,252239,93013,65914,27099,32629,47768,-15139,-11960,126597,138557,50.1893045881089,16.963774496012086,54.930839402312884,-8.673072927236625
40,2020-09-10,240000.0,2000.0,307926,102175,171241,-69066,127046,49508,77538,-8472,78705,87177,25.559712398433387,-24.62959218967551,28.311022778199955,-26.61981662411293
41,2020-09-09,238000.0,-3500.0,308688,122291,101941,20350,64175,65674,-1499,-18851,122222,141073,39.59402373918001,14.034311340746623,45.700837091172964,17.38981431297301
42,2020-09-08,241500.0,-2000.0,295082,84361,124691,-40330,52463,61310,-8847,49177,158258,109081,53.63187181868091,14.037848079500897,36.966334781518356,-8.734502309654609
43,2020-09-07,243500.0,6000.0,366779,104330,95858,8472,65062,65349,-287,-8185,197387,205572,53.81633081501395,0.18445899633304208,56.047919864550586,19.08158508303223
44,2020-09-04,237500.0,-3500.0,485708,105511,158675,-53164,143332,153270,-9938,63102,236865,173763,48.766954631177576,-5.049376183836372,35.7751982672717,-20.27272159727889
45,2020-09-03,241000.0,-1500.0,370100,87368,137457,-50089,93265,116016,-22751,72840,189467,116627,51.19346122669549,2.426506595517914,31.51229397460146,-4.262904292670239
46,2020-09-02,242500.0,500.0,370388,83298,176292,-92994,85464,53170,32294,60700,201626,140926,54.43642882598788,3.242967599292392,38.04820890525611,6.535914930654652
47,2020-09-01,242000.0,-6000.0,528401,124561,289348,-164787,178078,118819,59259,105528,225762,120234,42.725505818497695,-11.710923007490187,22.754309700397993,-15.293899204858118
48,2020-08-31,248000.0,5500.0,2365827,199472,458695,-259223,1892124,1458260,433864,-174641,274231,448872,11.591337828167486,-31.13416799033021,18.9731539964672,-3.781155703930793
49,2020-08-28,242500.0,-3000.0,845757,166167,334962,-168795,171324,126036,45288,123507,508266,384759,60.09598501697296,48.50464718880548,45.492854330499185,26.519700334031985
50,2020-08-27,245500.0,-3000.0,578642,138557,191029,-52472,121090,174929,-53839,106311,318995,212684,55.12821399068854,-4.967771026284417,36.755714241275264,-8.73714008922392
51,2020-08-26,248500.0,1000.0,494139,118564,172175,-53611,114996,105713,9283,44328,260579,216251,52.733947330609396,-2.394266660079147,43.7631921382445,7.007477896969235
52,2020-08-25,247500.0,5500.0,632697,162082,202687,-40605,183286,105921,77365,-36760,287329,324089,45.41336532336964,-7.320582007239757,51.22341341906157,7.460221280817073
53,2020-08-24,242000.0,6500.0,537847,146102,184440,-38338,119970,106744,13226,25112,271775,246663,50.5301693604315,5.116804037061861,45.861183570792434,-5.362229848269138
54,2020-08-21,235500.0,8000.0,559220,210853,207819,3034,152145,65816,86329,-89363,196222,285585,35.08851614749115,-15.441653212940352,51.06845248739316,5.207268916600725
55,2020-08-20,227500.0,-3500.0,673961,188287,266355,-78068,195520,161136,34384,43684,290154,246470,43.052046038272245,7.963529890781096,36.57036534754978,-14.498087139843378
56,2020-08-19,231000.0,2000.0,436293,161154,176920,-15766,154450,124156,30294,-14528,120689,135217,27.662373680072793,-15.389672358199451,30.992246036493825,-5.578119311055957
57,2020-08-18,229000.0,-8000.0,735510,202822,266903,-64081,297031,173298,123733,-59652,235657,295309,32.03994507212683,4.377571392054033,40.15023589074248,9.157989854248655
58,2020-08-14,237000.0,-5000.0,527180,232692,166273,66419,114077,203276,-89199,22780,180411,157631,34.22189764406844,2.181952571941615,29.900792898061386,-10.249442992681093
59,2020-08-13,242000.0,500.0,955607,368965,413271,-44306,367157,218120,149037,-104731,219485,324216,22.968123925421224,-11.253773718647217,33.92775481971145,4.0269619216500665
60,2020-08-12,241500.0,4500.0,565000,202105,209579,-7474,143247,67500,75747,-68273,219648,287921,38.87575221238938,15.907628286968155,50.959469026548675,17.031714206837222
61,2020-08-11,237000.0,-1000.0,530433,190252,170303,19949,105534,172300,-66766,46817,234647,187830,44.23687817311517,5.3611259607257935,35.41069277363965,-15.548776252909022
62,2020-08-10,238000.0,9000.0,812761,323346,243354,79992,146820,100062,46758,-126750,342595,469345,42.15199794281468,-2.0848802303004916,57.74698835204938,22.336295578409725
63,2020-08-07,229000.0,8500.0,858608,279327,212938,66389,251673,178238,73435,-139824,327608,467432,38.15571250209642,-3.9962854407182604,54.44067607103591,-3.3063122810134686
64,2020-08-06,220500.0,-6500.0,1057486,353347,446794,-93447,244914,162635,82279,11168,459225,448057,43.42610682316362,5.270394321067201,42.370017191716954,-12.070658879318955
65,2020-08-05,227000.0,1500.0,631091,249758,131491,118267,76743,258915,-182172,63905,304590,240685,48.264037991351486,4.837931168187865,38.13792305705516,-4.232094134661793
66,2020-08-04,225500.0,6500.0,776036,392922,232217,160705,90935,201551,-110616,-50089,292179,342268,37.65018633156193,-10.613851659789553,44.10465493868841,5.966731881633251
67,2020-08-03,219000.0,-1500.0,418322,208449,124246,84203,50758,157421,-106663,22460,159115,136655,38.0364886379392,0.38630230637726726,32.667418878280365,-11.437236060408047
68,2020-07-31,220500.0,500.0,730524,375238,183800,191438,184350,316683,-132333,-59105,170936,230041,23.399094348714076,-14.637394289225124,31.489862071608872,-1.1775568066714932
69,2020-07-30,220000.0,3500.0,733171,345140,183687,161453,132731,215876,-83145,-78308,255300,333608,34.82134454308749,11.422250194373415,45.50207250423162,14.012210432622748
70,2020-07-29,216500.0,2500.0,420463,153418,115451,37967,143647,157019,-13372,-24595,123398,147993,29.348123378275854,-5.473221164811637,35.19762737743868,-10.304445126792942
71,2020-07-28,214000.0,5500.0,418247,151033,113459,37574,162064,124317,37747,-75321,105150,180471,25.14064655574338,-4.207476822532474,43.14938302008143,7.951755642642752
72,2020-07-27,208500.0,500.0,284315,79083,84728,-5645,111011,139693,-28682,34327,94221,59894,33.13965144294181,7.999004887198431,21.06607108312963,-22.0833119369518
73,2020-07-24,208000.0,-3500.0,285942,65729,76725,-10996,35122,138107,-102985,113981,185091,71110,64.73025998279371,31.5906085398519,24.86867966230914,3.8026085791795126
74,2020-07-23,211500.0,-3000.0,378989,107223,138370,-31147,55209,153683,-98474,129621,216557,86936,57.140708569378006,-7.589551413415705,22.9389243487278,-1.9297553135813423
75,2020-07-22,214500.0,-1000.0,310544,62288,91106,-28818,107770,137857,-30087,58905,140486,81581,45.23867793291772,-11.902030636460289,26.27035138337884,3.3314270346510426
76,2020-07-21,215500.0,-1000.0,305567,97943,82158,15785,79815,167499,-87684,71899,127809,55910,41.82683339496739,-3.41184453795033,18.297132871023376,-7.973218512355466
77,2020-07-20,216500.0,-500.0,261245,83622,84510,-888,102790,103324,-534,1422,74833,73411,28.644758751363664,-13.182074643603723,28.100442113724668,9.803309242701292
78,2020-07-17,217000.0,-1000.0,202037,47354,58892,-11538,69267,101061,-31794,43332,85416,42084,42.2774046338047,13.632645882441036,20.829847998138952,-7.270594115585716
79,2020-07-16,218000.0,0.0,243527,121944,73704,48240,34607,113096,-78489,30249,86976,56727,35.71513630932094,-6.56226832448376,23.29392634081642,2.4640783426774675
80,2020-07-15,218000.0,500.0,301947,116657,102653,14004,41914,147760,-105846,91842,143376,51534,47.48382994366561,11.768693634344672,17.06723365358821,-6.2266926872282085
81,2020-07-14,217500.0,2000.0,375098,200136,153710,46426,76530,104598,-28068,-18358,98432,116790,26.241675508800366,-21.242154434865245,31.1358631610939,14.06862950750569
82,2020-07-13,215500.0,500.0,221105,83769,47697,36072,43722,114666,-70944,34872,93614,58742,42.33916012754121,16.097484618740847,26.56746794509396,-4.568395215999942
83,2020-07-10,215000.0,-3000.0,283753,76268,94002,-17734,111881,112068,-187,17921,95604,77683,33.692683425373474,-8.646476702167739,27.376979274227935,0.8095113291339757
84,2020-07-09,218000.0,-500.0,260664,105818,104447,1371,50174,83037,-32863,31492,104672,73180,40.15590952337108,6.463226097997605,28.07445600466501,0.6974767304370744
85,2020-07-08,218500.0,500.0,374455,154849,125712,29137,143882,167381,-23499,-5638,75724,81362,20.22245663697908,-19.933452886392,21.728111522078756,-6.346344482586254
86,2020-07-07,218000.0,-7000.0,452166,96477,155672,-59195,123339,172313,-48974,108169,232350,124181,51.38599540876581,31.16353877178673,27.463586381992457,5.735474859913701
87,2020-07-06,225000.0,4000.0,281508,108011,79273,28738,99414,36766,62648,-91386,74083,165469,26.316481236767693,-25.069514171998115,58.77950182588061,31.31591544388815
88,2020-07-03,221000.0,-4000.0,283845,103474,116275,-12801,40550,56350,-15800,28601,139821,111220,49.25963113671194,22.943149899944245,39.18335711391781,-19.5961447119628
89,2020-07-02,225000.0,3000.0,447600,222955,77148,145807,100749,100409,340,-146147,123896,270043,27.680071492403936,-21.579559644308002,60.33132260947275,21.147965495554942
90,2020-07-01,222000.0,11000.0,872553,422295,208413,213882,211079,126751,84328,-298210,239179,537389,27.41140079743007,-0.2686706949738671,61.58812129463769,1.256798685164938
91,2020-06-30,211000.0,4000.0,346277,95780,74432,21348,175512,123395,52117,-73465,74985,148450,21.65462909751442,-5.7567716999156495,42.87030325433107,-18.717818040306618
92,2020-06-29,207000.0,-1500.0,314859,71273,107930,-36657,145151,118746,26405,10252,98435,88183,31.263200353173957,9.608571255659538,28.007139703803922,-14.863163550527148
93,2020-06-26,208500.0,5500.0,308368,114917,91065,23852,46743,37363,9380,-33232,146708,179940,47.575623929850046,16.31242357667609,58.35235822134592,30.345218517542
94,2020-06-25,203000.0,-2500.0,249665,53263,108495,-55232,24633,56453,-31820,87052,171769,84717,68.79979172090601,21.22416779105597,33.932269240782645,-24.42008898056328
95,2020-06-24,205500.0,0.0,217711,48562,54793,-6231,29608,110729,-81121,87352,139541,52189,64.09460247759645,-4.705189243309562,23.971687236749638,-9.960582004033007
96,2020-06-23,205500.0,-1000.0,290774,67065,86576,-19511,92074,103732,-11658,31169,131635,100466,45.27055376340388,-18.82404871419257,34.55123222846609,10.579544991716453
97,2020-06-22,206500.0,500.0,238220,67366,54875,12491,71000,77498,-6498,-5993,99854,105847,41.91671564100412,-3.3538381223997646,44.43245739232642,9.881225163860329
98,2020-06-19,206000.0,500.0,243216,55051,63979,-8928,82901,111917,-29016,37944,105264,67320,43.28004736530492,1.3633317243007994,27.67910005920663,-16.75335733311979
99,2020-06-18,205500.0,-1500.0,260278,71434,60588,10846,68594,146956,-78362,67516,120250,52734,46.20060089596508,2.9205535306601647,20.260644387923683,-7.4184556712829455
100,2020-06-17,207000.0,-2000.0,342902,145060,110950,34110,85274,151446,-66172,32062,112568,80506,32.82803833165161,-13.37256256431347,23.477844981948195,3.2172005940245114
101,2020-06-16,209000.0,8000.0,351512,116626,93624,23002,91560,136747,-45187,22185,143326,121141,40.7741414233369,7.946103091685288,34.4628348392089,10.984989857260707
102,2020-06-15,201000.0,-7500.0,421888,61737,108452,-46715,58091,148640,-90549,137264,302060,164796,71.59720115291263,30.823059729575732,39.06155188106796,4.598717041859061
103,2020-06-12,208500.0,-6500.0,461453,92786,102516,-9730,77339,210176,-132837,142567,291328,148761,63.132756748791316,-8.464444404121316,32.237519313992976,-6.824032567074987
104,2020-06-11,215000.0,-4000.0,450027,108351,212699,-104348,71829,119343,-47514,151862,269847,117985,59.962402255864646,-3.17035449292667,26.217315849937894,-6.020203464055083
105,2020-06-10,219000.0,-2000.0,255142,77056,79142,-2086,48543,113594,-65051,67137,129543,62406,50.772902932484655,-9.18949932337999,24.459320692006802,-1.7579951579310915
106,2020-06-09,221000.0,-1500.0,208905,68331,91213,-22882,30690,18629,12061,10821,109884,99063,52.59998563940547,1.8270827069208124,47.42011919293459,22.96079850092779
107,2020-06-08,222500.0,-1000.0,248567,53130,121099,-67969,43746,49311,-5565,73534,151691,78157,61.02620219095858,8.426216551553111,31.44303145630756,-15.977087736627034
108,2020-06-05,223500.0,-3500.0,309300,95434,88710,6724,31270,139780,-108510,101786,182596,80810,59.035240866472684,-1.9909613244858946,26.126737795021015,-5.316293661286544
109,2020-06-04,227000.0,-3000.0,350089,134462,126640,7822,101929,115518,-13589,5767,113698,107931,32.47688444938287,-26.55835641708981,30.82958904735653,4.702851252335517
110,2020-06-03,230000.0,5000.0,366533,130630,117923,12707,128306,77351,50955,-63662,107597,171259,29.355337718568315,-3.1215467308145577,46.72403303386052,15.89444398650399
111,2020-06-02,225000.0,500.0,328734,77566,86458,-8892,123081,123332,-251,9143,128087,118944,38.963721428267235,9.60838370969892,36.182445381372176,-10.541587652488346
112,2020-06-01,224500.0,8500.0,424075,108239,87945,20294,172730,80916,91814,-112108,143106,255214,33.74544597064199,-5.218275457625246,60.18133584861168,23.998890467239505
113,2020-05-29,216000.0,4000.0,466946,117044,120656,-3612,223729,136082,87647,-84035,126173,210208,27.020897491358742,-6.724548479283246,45.017625164365896,-15.163710684245785
114,2020-05-28,212000.0,2000.0,277022,97500,99138,-1638,94296,63064,31232,-29594,85226,114820,30.76506559045852,3.7441680990997774,41.44797164124149,-3.5696535231244084
115,2020-05-27,210000.0,-2000.0,301224,59621,76851,-17230,112623,157334,-44711,61941,128980,67039,42.81863330943085,12.053567718972332,22.255530767800707,-19.19244087344078
116,2020-05-26,212000.0,0.0,225724,84762,62918,21844,31518,60590,-29072,7228,109444,102216,48.48576137229537,5.667128062864521,45.283620704931685,23.02808993713098
117,2020-05-25,212000.0,3500.0,170965,67915,47233,20682,5918,22814,-16896,-3786,97132,100918,56.81396777118124,8.328206398885868,59.02845611674904,13.744835411817355
118,2020-05-22,208500.0,-4500.0,241670,80541,65122,15419,30289,86923,-56634,41215,130840,89625,54.139942897339346,-2.674024873841894,37.08569536971904,-21.94276074703
119,2020-05-21,213000.0,1500.0,230542,63911,94640,-30729,71816,39917,31899,-1170,94815,95985,41.12699638243791,-13.012946514901437,41.63449610049362,4.54880073077458
120,2020-05-20,211500.0,2500.0,246227,103247,73962,29285,47493,61253,-13760,-15525,95487,111012,38.780068798304,-2.3469275841339083,45.08522623432849,3.450730133834867
121,2020-05-19,209000.0,3500.0,243581,86744,80014,6730,44789,42501,2288,-9018,112048,121066,46.00030380037852,7.220235002074517,49.702563007787965,4.617336773459478
122,2020-05-18,205500.0,1500.0,239427,86348,63939,22409,50058,113305,-63247,40838,103021,62183,43.02814636611576,-2.972157434262755,25.97159050566561,-23.730972502122356
123,2020-05-15,204000.0,-3000.0,304146,85245,50201,35044,45830,195739,-149909,114865,173071,58206,56.90392114313521,13.875774777019444,19.13751948077568,-6.83407102488993
124,2020-05-14,207000.0,500.0,265261,126209,102844,23365,57256,98609,-41353,17988,81796,63808,30.83604449956835,-26.06787664356686,24.054798858482776,4.917279377707096
125,2020-05-13,206500.0,-3500.0,297218,119991,73885,46106,36024,171680,-135656,89550,141203,51653,47.50822628508368,16.67218178551533,17.378826316037387,-6.67597254244539
126,2020-05-12,210000.0,5000.0,319403,139749,99494,40255,82576,70260,12316,-52571,97078,149649,30.39357801899168,-17.114648266092,46.852722109685885,29.4738957936485
127,2020-05-11,205000.0,-2000.0,229714,67560,94831,-27271,43043,82444,-39401,66672,119111,52439,51.851867974960165,21.458289955968485,22.827951278546365,-24.02477083113952
128,2020-05-08,207000.0,0.0,251268,104063,86408,17655,41001,81978,-40977,23322,106204,82882,42.26722065682856,-9.584647318131601,32.98549755639397,10.157546277847608
129,2020-05-07,207000.0,500.0,262232,83618,66858,16760,72512,137096,-64584,47824,106102,58278,40.46111839897495,-1.8061022578536097,22.22383233167577,-10.761665224718204
130,2020-05-06,206500.0,-2000.0,301863,60152,127741,-67589,101014,125668,-24654,92243,140697,48454,46.60955466552708,6.148436266552125,16.051652570868242,-6.172179760807527
131,2020-05-04,208500.0,-3000.0,311878,85238,122607,-37369,128262,132336,-4074,41443,98378,56935,31.543744669389955,-15.065809996137123,18.25553581849313,2.203883247624887
132,2020-04-29,211500.0,-1500.0,285877,79805,80437,-632,116685,148550,-31865,32497,89387,56890,31.267643077267497,-0.27610159212245833,19.900166854976092,1.6446310364829628
133,2020-04-28,213000.0,0.0,230434,64134,55463,8671,111897,127843,-15946,7275,54403,47128,23.608929237872882,-7.658713839394615,20.451843043995243,0.551676189019151
134,2020-04-27,213000.0,3500.0,239588,75476,59120,16356,106064,92385,13679,-30035,58048,88083,24.228258510442927,0.6193292725700452,36.764362155032806,16.312519111037563
135,2020-04-24,209500.0,-6000.0,290083,65393,64349,1044,92100,140283,-48183,47139,132590,85451,45.707607822588706,21.47934931214578,29.45743114901597,-7.3069310060168355
136,2020-04-23,215500.0,1000.0,320469,95480,72229,23251,79142,130551,-51409,28158,145847,117689,45.5104861936724,-0.1971216289163067,36.72398890376292,7.266557754746952
137,2020-04-22,214500.0,5000.0,446614,158363,152993,5370,174258,137769,36489,-41859,113993,155852,25.523830421796,-19.9866557718764,34.89635345063075,-1.8276354531321743
138,2020-04-21,209500.0,6000.0,507880,146699,118645,28054,250494,191512,58982,-87036,110687,197723,21.793927699456564,-3.7299027223394354,38.93104670394582,4.034693253315069
139,2020-04-20,203500.0,4500.0,340368,113746,97670,16076,93108,109667,-16559,483,133514,133031,39.226366755981765,17.4324390565252,39.084461523997554,0.15341482005173646
140,2020-04-17,199000.0,2500.0,279720,60195,89894,-29699,70398,53017,17381,12318,149127,136809,53.312955812955806,14.086589056974042,48.90926640926641,9.824804885268854
141,2020-04-16,196500.0,500.0,400946,106416,82843,23573,135352,199386,-64034,40461,159178,118717,39.70060806193353,-13.612347751022277,29.60922418480294,-19.300042224463468
142,2020-04-14,196000.0,6000.0,270715,91072,60886,30186,93082,81483,11599,-41785,86561,128346,31.97495521119997,-7.72565285073356,47.410006833755055,17.800782648952115
143,2020-04-13,190000.0,-4000.0,240625,104552,96695,7857,34158,84544,-50386,42529,101915,59386,42.354285714285716,10.379330503085747,24.679896103896105,-22.73011072985895
144,2020-04-10,194000.0,500.0,195673,68410,69834,-1424,31842,44951,-13109,14533,95421,80888,48.76554251225259,6.411256797966871,41.33835531728956,16.658459213393456
145,2020-04-09,193500.0,-500.0,379481,88311,158917,-70606,141218,141203,15,70591,149952,79361,39.51502183245011,-9.250520679802477,20.9130364893104,-20.42531882797916
146,2020-04-08,194000.0,3500.0,536169,178151,157676,20475,242393,228706,13687,-34162,115625,149787,21.565028936771803,-17.949992895678307,27.93652747547881,7.023490986168412
147,2020-04-07,190500.0,0.0,365459,91322,111674,-20352,93600,135952,-42352,62704,180537,117833,49.4000695016404,27.8350405648686,32.24246769131421,4.305940215835399
148,2020-04-06,190500.0,7500.0,417491,179068,81330,97738,89132,191705,-102573,4835,149291,144456,35.75909420801885,-13.640975293621551,34.600985410463934,2.3585177191497237
149,2020-04-03,183000.0,1000.0,385855,118689,151354,-32665,181608,125029,56579,-23914,85558,109472,22.17361444065776,-13.58547976736109,28.371279366601442,-6.2297060438624925
150,2020-04-02,182000.0,7000.0,458271,176933,119101,57832,164439,194656,-30217,-27615,116899,144514,25.508705547590836,3.335091106933074,31.534615980500618,3.163336613899176
151,2020-04-01,175000.0,-2000.0,549624,139205,145239,-6034,211142,231395,-20253,26287,199277,172990,36.25696840021542,10.748262852624585,31.474244210587603,-0.06037176991301507
152,2020-03-31,177000.0,1000.0,993798,131895,118011,13884,675722,765892,-90170,76286,186181,109895,18.734290066995506,-17.522678333219915,11.058082225965437,-20.416161984622164
153,2020-03-30,176000.0,-500.0,386801,144627,99721,44906,137160,176255,-39095,-5811,105014,110825,27.149361040948705,8.415070973953199,28.651683940837795,17.593601714872356
154,2020-03-27,176500.0,3500.0,524568,164770,133004,31766,147383,225360,-77977,46211,212415,166204,40.4933202177792,13.343959176830495,31.683976147992254,3.032292207154459
155,2020-03-26,173000.0,-1500.0,680107,198127,147069,51058,216790,355980,-139190,88132,265190,177058,38.99239384390986,-1.5009263738693406,26.03384467444093,-5.650131473551323
156,2020-03-25,174500.0,3500.0,690024,242074,220851,21223,157588,308926,-151338,130115,290362,160247,42.07998562368845,3.0875917797785917,23.223395128285393,-2.8104495461555388
157,2020-03-24,171000.0,5500.0,417692,144433,129428,15005,95264,169959,-74695,59690,177995,118305,42.61393562720856,0.5339500035201112,28.323501527441273,5.10010639915588
158,2020-03-23,165500.0,-9500.0,341417,123035,126522,-3487,109531,140096,-30565,34052,108851,74799,31.882126549058775,-10.731809078149787,21.908399406004975,-6.415102121436298
159,2020-03-20,175000.0,2000.0,403851,159787,143385,16402,108720,180726,-72006,55604,135344,79740,33.513350220749736,1.631223671690961,19.744905918271836,-2.163493487733138
160,2020-03-19,173000.0,-7000.0,575925,222259,215811,6448,228623,191319,37304,-43752,125043,168795,21.71168120849069,-11.801669012259048,29.30850371142076,9.563597793148922
161,2020-03-18,180000.0,-7500.0,278157,85992,104901,-18909,84447,102708,-18261,37170,107718,70548,38.72561179477777,17.01393058628708,25.362654903525705,-3.9458488078950538
162,2020-03-17,187500.0,-5500.0,426215,131382,128378,3004,158595,221048,-62453,59449,136238,76789,31.96461879567824,-6.760992999099528,18.016494022969628,-7.346160880556077
163,2020-03-16,193000.0,-4000.0,360423,101706,111871,-10165,163181,180129,-16948,27113,95536,68423,26.50663248460836,-5.457986311069881,18.984082591843475,0.9675885688738468
164,2020-03-13,197000.0,-14500.0,670552,237752,198479,39273,204042,294552,-90510,51237,228758,177521,34.114878488170945,7.608246003562584,26.473860341927246,7.489777750083771
165,2020-03-12,211500.0,-6000.0,390463,189934,178007,11927,143674,128336,15338,-27265,56855,84120,14.560918704205008,-19.553959783965936,21.54365458442925,-4.930205757497994
166,2020-03-11,217500.0,-1000.0,248264,114177,113370,807,107312,102370,4942,-5749,26775,32524,10.784890278091064,-3.7760284261139443,13.100570360583893,-8.443084223845359
167,2020-03-10,218500.0,-500.0,207340,122114,90300,31814,64701,73303,-8602,-23212,20525,43737,9.899199382656507,-0.885690895434557,21.094337802643,7.993767442059108
168,2020-03-09,219000.0,-3500.0,285073,145813,118780,27033,103933,107105,-3172,-23861,35327,59188,12.392264437530036,2.4930650548735294,20.762401209514756,-0.3319365931282441
169,2020-03-06,222500.0,1000.0,390707,151855,146542,5313,219023,180599,38424,-43737,19829,63566,5.075158622701922,-7.317105814828114,16.26948071060923,-4.4929204989055265
170,2020-03-05,221500.0,2000.0,373464,102529,142943,-40414,234611,171645,62966,-22552,36324,58876,9.726238673607094,4.651080050905172,15.764839449049974,-0.5046412615592555
171,2020-03-04,219500.0,12500.0,353005,127158,151804,-24646,183606,65943,117663,-93017,42241,135258,11.966119460064304,2.23988078645721,38.31617115904874,22.55133170999877
172,2020-03-03,207000.0,-1000.0,224882,88826,141140,-52314,76471,51470,25001,27313,59585,32272,26.496117964087833,14.52999850402353,14.350637223076992,-23.96553393597175
173,2020-03-02,208000.0,-4500.0,291418,107063,132053,-24990,62791,92319,-29528,54518,121564,67046,41.71465043339808,15.218532469310244,23.006814953091435,8.656177730014443
174,2020-02-28,212500.0,-4500.0,301784,157214,123700,33514,61904,100850,-38946,5432,82666,77234,27.39243962569255,-14.322210807705527,25.5924767383294,2.5856617852379635
175,2020-02-27,217000.0,1000.0,168477,98758,84784,13974,43818,52314,-8496,-5478,25901,31379,15.37361182832078,-12.01882779737177,18.62509422651163,-6.9673825118177675
176,2020-02-26,216000.0,-1500.0,226926,84640,92521,-7881,104779,104854,-75,7956,37507,29551,16.52829556771811,1.1546837393973313,13.022306831301833,-5.602787395209798
177,2020-02-25,217500.0,0.0,230733,74950,81299,-6349,103521,105167,-1646,7995,52262,44267,22.650422783043606,6.122127215325495,19.185378771133735,6.163071939831902
178,2020-02-24,217500.0,-2000.0,330240,131704,126684,5020,138824,115836,22988,-28008,59712,87720,18.08139534883721,-4.569027434206397,26.5625,7.377121228866265
179,2020-02-21,219500.0,-2500.0,221992,63611,92410,-28799,67880,61626,6254,22545,90501,67956,40.76768532199358,22.686289973156374,30.611913942844787,4.049413942844787
180,2020-02-20,222000.0,-3000.0,195361,40737,81220,-40483,36978,78708,-41730,82213,117646,35433,60.21979821970608,19.452112897712496,18.13719217243974,-12.474721770405047
181,2020-02-19,225000.0,-1000.0,171576,55963,62005,-6042,60953,79847,-18894,24936,54660,29724,31.857602461882784,-28.362195757823294,17.324101272905303,-0.813090899534437
182,2020-02-18,226000.0,-2000.0,164174,58974,54504,4470,38026,75407,-37381,32911,67174,34263,40.9163448536309,9.058742391748119,20.869930683299426,3.5458294103941235
183,2020-02-17,228000.0,500.0,102123,50924,57619,-6695,16697,16264,433,6262,34502,28240,33.78474976254125,-7.13159509108965,27.652928331521792,6.782997648222366
184,2020-02-14,227500.0,-1000.0,183907,87705,65977,21728,48549,67924,-19375,-2353,47653,50006,25.911466121463565,-7.873283641077688,27.19091714834128,-0.46201118318051115
185,2020-02-13,228500.0,2000.0,400126,146015,208970,-62955,182464,72752,109712,-46757,71647,118404,17.906109575483722,-8.005356545979843,29.591678621234312,2.4007614728930307
186,2020-02-12,226500.0,3000.0,252165,96933,102779,-5846,103983,89901,14082,-8236,51249,59485,20.3235976443995,2.4174880689157767,23.589713084686615,-6.001965536547697
187,2020-02-11,223500.0,-1500.0,306497,77195,144708,-67513,72097,124548,-52451,119964,157205,37241,51.290877235339984,30.967279590940485,12.15052675882635,-11.439186325860264
188,2020-02-10,225000.0,-3500.0,211696,67874,137866,-69992,45359,43933,1426,68566,98463,29897,46.51150706673721,-4.7793701686027745,14.122609780061977,1.9720830212356262
189,2020-02-07,228500.0,-500.0,219283,75634,125496,-49862,74556,60831,13725,36137,69093,32956,31.508598477766174,-15.002908588971035,15.028980814746241,0.9063710346842644
190,2020-02-06,229000.0,4000.0,252885,111489,112502,-1013,101678,97547,4131,-3118,39718,42836,15.705953298930345,-15.80264517883583,16.938924807718927,1.9099439929726856
191,2020-02-05,225000.0,-1500.0,211857,65289,163748,-98459,67643,28412,39231,59228,78925,19697,37.253902396427776,21.54794909749743,9.297309033923826,-7.641615773795101
192,2020-02-04,226500.0,0.0,227378,72616,171833,-99217,95899,39157,56742,42475,58863,16388,25.88772880401798,-11.366173592409798,7.207381540870268,-2.0899274930535574
193,2020-02-03,226500.0,-3000.0,203206,72044,97485,-25441,78350,67968,10382,15059,52812,37753,25.989390077064655,0.10166127304667683,18.57868370028444,11.37130215941417
194,2020-01-31,229500.0,500.0,220742,87221,104427,-17206,107680,84108,23572,-6366,25841,32207,11.706426506962881,-14.282963570101774,14.590336229625537,-3.988347470658903
195,2020-01-30,229000.0,-3500.0,279645,73460,132983,-59523,117700,112444,5256,54267,88485,34218,31.6419031271791,19.935476620216217,12.236228074880652,-2.3541081547448854
196,2020-01-29,232500.0,0.0,127679,40421,97046,-56625,48470,11553,36917,19708,38788,19080,30.379310614901435,-1.2625925122776636,14.94372606301741,2.7074979881367582
197,2020-01-28,232500.0,-4500.0,319257,115725,95473,20252,130934,142265,-11331,-8921,72598,81519,22.739673679825344,-7.639636935076091,25.533974196337123,10.590248133319713
198,2020-01-23,237000.0,-1500.0,175821,60248,102516,-42268,88490,48159,40331,1937,27083,25146,15.403734479954046,-7.335939199871298,14.302045830702816,-11.231928365634307
199,2020-01-22,238500.0,2000.0,145035,66027,69693,-3666,63470,19184,44286,-40620,15538,56158,10.713276105767573,-4.690458374186473,38.720308890957355,24.41826306025454
200,2020-01-21,236500.0,500.0,90895,41471,46144,-4673,32470,12940,19530,-14857,16954,31811,18.652291105121293,7.93901499935372,34.99752461631553,-3.7227842746418247
201,2020-01-20,236000.0,1000.0,240407,108851,106997,1854,85830,68225,17605,-19459,45726,65185,19.020244834800984,0.36795372967969087,27.114435103803135,-7.883089512512395
202,2020-01-17,235000.0,-1000.0,272364,106374,194807,-88433,85938,38636,47302,41131,80052,38921,29.391549543992596,10.371304709191612,14.290067703514413,-12.824367400288722
203,2020-01-16,236000.0,-1500.0,221714,69941,149947,-80006,102787,50032,52755,27251,48986,21735,22.09422950287307,-7.2973200411195265,9.803169849445682,-4.486897854068731
204,2020-01-15,237500.0,1500.0,211141,94516,120522,-26006,90381,52921,37460,-11454,26244,37698,12.429608650143743,-9.664620852729326,17.854419558494087,8.051249709048404
205,2020-01-14,236000.0,1500.0,240866,87115,107168,-20053,110208,67884,42324,-22271,43543,65814,18.077686348426095,5.648077698282352,27.32390623832338,9.469486679829295
206,2020-01-13,234500.0,3500.0,164096,71090,85425,-14335,43823,30921,12902,1433,49183,47750,29.97208950858034,11.894403160154244,29.098820202808113,1.7749139644847318
207,2020-01-10,231000.0,-1000.0,197124,61589,148708,-87119,35855,21355,14500,72619,99680,27061,50.56715569895091,20.595066190370574,13.727907307075748,-15.370912895732365
208,2020-01-09,232000.0,-500.0,534218,179541,246092,-66551,279107,262126,16981,49570,75570,26000,14.145910471006218,-36.421245227944695,4.866926984863857,-8.86098032221189
209,2020-01-08,232500.0,-500.0,278235,88625,142537,-53912,142624,65823,76801,-22889,46986,69875,16.887163728502884,2.741253257496666,25.113662910848745,20.246735925984886
210,2020-01-07,233000.0,1500.0,136767,50878,67263,-16385,66543,44285,22258,-5873,19346,25219,14.145225090847937,-2.741938637654947,18.439389618840803,-6.674273292007943
211,2020-01-06,231500.0,-2500.0,225461,60576,123740,-63164,93082,58637,34445,28719,71803,43084,31.847193084391535,17.701967993543597,19.109291629150942,0.669902010310139
212,2020-01-03,234000.0,0.0,262330,82189,199395,-117206,107274,39121,68153,49053,72867,23814,27.776845957381923,-4.070347127009612,9.077879007357145,-10.031412621793796
213,2020-01-02,234000.0,-4000.0,265743,70604,175543,-104939,61472,55298,6174,98765,133667,34902,50.29934937138514,22.522503414003218,13.13374199884851,4.055862991491365
214,2019-12-30,238000.0,500.0,96960,28470,39604,-11134,38862,24857,14005,-2871,29628,32499,30.556930693069305,-19.742418678315836,33.51794554455446,20.384203545705947
215,2019-12-27,237500.0,-7000.0,302632,83702,195957,-112255,83667,58721,24946,87309,135263,47954,44.69553781490391,14.138607121834603,15.845647519099105,-17.672298025455355
216,2019-12-26,244500.0,2000.0,254431,96346,92712,3634,30492,41588,-11096,7462,127593,120131,50.148370285067465,5.452832470163557,47.215551564078275,31.369904044979172
217,2019-12-24,242500.0,-1500.0,168656,70323,82318,-11995,34272,50889,-16617,28612,64061,35449,37.98323214116308,-12.165138143904386,21.018522910539797,-26.197028653538478
218,2019-12-23,244000.0,500.0,126535,62613,51847,10766,19689,32364,-12675,1909,44233,42324,34.9571264867428,-3.0261056544202773,33.44845299719445,12.429930086654654
219,2019-12-20,243500.0,500.0,161679,49132,49740,-608,78767,75866,2901,-2293,33780,36073,20.893251442673446,-14.063875044069356,22.311493762331533,-11.136959234862918
220,2019-12-19,243000.0,1000.0,153313,76721,46385,30336,58595,66090,-7495,-22841,17997,40838,11.738730570793084,-9.154520871880361,26.637010560096012,4.325516797764479
221,2019-12-18,242000.0,1500.0,160213,70982,81899,-10917,53482,48226,5256,5661,35749,30088,22.313420259279834,10.57468968848675,18.779999126163297,-7.8570114339327155
222,2019-12-17,240500.0,-1000.0,225134,79509,77054,2455,75038,133139,-58101,55646,70587,14941,31.353327351710536,9.039907092430703,6.636492044737801,-12.143507081425497
223,2019-12-16,241500.0,1000.0,135514,73187,60962,12225,24841,60369,-35528,23303,37486,14183,27.662086574080906,-3.6912407776296305,10.466077305665836,3.8295852609280354
224,2019-12-13,240500.0,1000.0,203385,97634,93904,3730,67275,79340,-12065,8335,38476,30141,18.91781596479583,-8.744270609285074,14.819676967327974,4.3535996616621375
225,2019-12-12,239500.0,-1500.0,355293,207572,202843,4729,95251,134676,-39425,34696,52470,17774,14.768092813536995,-4.149723151258836,5.002631630794865,-9.81704533653311
226,2019-12-11,241000.0,1000.0,147833,67888,65746,2142,67129,58141,8988,-11130,12816,23946,8.669241644287812,-6.098851169249183,16.198007210839258,11.195375580044391
227,2019-12-10,240000.0,1000.0,112422,67182,44026,23156,30211,51085,-20874,-2282,15029,17311,13.368379854476881,4.699138210189069,15.398231662841793,-0.7997755479974646
228,2019-12-09,239000.0,500.0,125986,55324,47858,7466,55182,58151,-2969,-4497,15480,19977,12.287079516771705,-1.0813003377051764,15.856523740733097,0.4582920778913042
229,2019-12-06,238500.0,500.0,141523,48424,44830,3594,56026,83923,-27897,24303,37073,12770,26.19574203486359,13.908662518091884,9.023268302678716,-6.8332554380543815
230,2019-12-05,238000.0,-1000.0,129556,53588,55110,-1522,41946,54901,-12955,14477,34022,19545,26.26045879773997,0.06471676287638317,15.086140356293804,6.062872053615088
231,2019-12-04,239000.0,-3500.0,986698,69041,81469,-12428,865760,880210,-14450,26878,51897,25019,5.259664051209185,-21.000794746530786,2.53562893610811,-12.550511420185693
232,2019-12-03,242500.0,500.0,114241,42117,33684,8433,47715,62670,-14955,6522,24409,17887,21.366234539263488,16.106570488054302,15.657250899414397,13.121621963306286
233,2019-12-02,242000.0,-4000.0,300055,63691,57597,6094,182949,224072,-41123,35029,53415,18386,17.80173634833614,-3.564498190927349,6.127543283731316,-9.52970761568308
234,2019-11-29,246000.0,-500.0,162450,72944,80470,-7526,68377,55769,12608,-5082,21129,26211,13.00646352723915,-4.795272821096988,16.134810710987995,10.007267427256679
235,2019-11-28,246500.0,1500.0,77308,44004,37138,6866,27439,18804,8635,-15501,5865,21366,7.586536969007089,-5.419926558232061,27.637501940290786,11.50269122930279
236,2019-11-27,245000.0,1000.0,91720,53163,42693,10470,25889,32193,-6304,-4166,12668,16834,13.81160052333188,6.22506355432479,18.35368512865242,-9.283816811638367
237,2019-11-26,244000.0,-2000.0,212106,68377,43235,25142,120579,154316,-33737,8595,23150,14555,10.914354143682875,-2.8972463796490047,6.8621349702507235,-11.491550158401695
238,2019-11-25,246000.0,1500.0,101864,45256,34413,10843,42707,43813,-1106,-9737,13901,23638,13.646626875049083,2.7322727313662085,23.20545040446085,16.343315434210126
239,2019-11-22,244500.0,3000.0,127697,59733,46208,13525,57426,42425,15001,-28526,10538,39064,8.252347353500864,-5.394279521548219,30.59116502345396,7.385714618993109
240,2019-11-21,241500.0,-3000.0,158938,80482,57466,23016,41652,61107,-19455,-3561,36804,40365,23.15619927267236,14.903851919171496,25.3966955668248,-5.194469456629161
241,2019-11-20,244500.0,-1000.0,123530,46270,49568,-3298,51990,53876,-1886,5184,25270,20086,20.45656925443212,-2.6996300182402386,16.260017809439002,-9.136677757385797
242,2019-11-19,245500.0,1000.0,150082,79938,65543,14395,47781,40720,7061,-21456,22363,43819,14.90052104849349,-5.556048205938632,29.19670580082888,12.936687991389878
243,2019-11-18,244500.0,1000.0,102730,46401,42481,3920,39148,35090,4058,-7978,17181,25159,16.724423245400565,1.823902196907076,24.49041175897985,-4.706294041849031
244,2019-11-15,243500.0,1500.0,109466,73207,30241,42966,22862,44748,-21886,-21080,13397,34477,12.238503279557122,-4.485919965843443,31.495624212084117,7.005212453104267
245,2019-11-14,242000.0,0.0,207577,162542,138684,23858,21556,49963,-28407,4549,23479,18930,11.310983394113991,-0.9275198854431306,9.119507459882357,-22.37611675220176
246,2019-11-13,242000.0,-2500.0,127741,61731,45424,16307,33740,59848,-26108,9801,32270,22469,25.262053686756797,13.951070292642806,17.58949749884532,8.469990038962962
247,2019-11-12,244500.0,2000.0,152076,86098,60434,25664,46104,62303,-16199,-9465,19874,29339,13.068465767116441,-12.193587919640356,19.2923275204503,1.7028300216049814
248,2019-11-11,242500.0,500.0,193224,125684,66816,58868,37041,77559,-40518,-18350,30499,48849,15.78427110503871,2.7158053379222693,25.28102099118122,5.988693470730919
249,합계,,,82767221,27914240,28066996,-152756,26297414,29341371,-3043957,3196713,28555567,25358854,34.50105809400076,18.71678698896205,30.638764590150974,5.357743598969755
