,날짜,종가,대비,거래량,기관 매수,기관 매도,기관 순매수,외국인 매수,외국인 매도,외국인 순매수,개인 순매수,개인 매수,개인 매도,개인매수비율(%),개인매수비율증가(%p),개인매도비율(%),개인매도비율증가(%p)
0,2020-11-11,58100.0,3600.0,4438993,1415614,1138982,276632,1089688,731902,357786,-634418,1933691,2568109,43.561478921007534,,57.853414051340025,
1,2020-11-10,54500.0,2200.0,3155193,821589,683405,138184,971052,546360,424692,-562876,1362552,1925428,43.184426436037356,-0.3770524849701786,61.024095831855604,3.1706817805155794
2,2020-11-09,52300.0,700.0,1662698,570903,368621,202282,221845,230790,-8945,-193337,869950,1063287,52.321588165740266,9.13716172970291,63.94949654116382,2.9254007093082137
3,2020-11-06,51600.0,-600.0,2214532,648551,762958,-114407,248443,313999,-65556,179963,1317538,1137575,59.49509873869513,7.173510572954861,51.36864132015252,-12.580855221011298
4,2020-11-05,52200.0,700.0,2424158,898997,851324,47673,323462,688549,-365087,317414,1201699,884285,49.57181008828632,-9.923288650408807,36.47802659727625,-14.890614722876272
5,2020-11-04,51500.0,500.0,2941439,1024917,865707,159210,437286,425980,11306,-170516,1479236,1649752,50.28953515609197,0.7177250678056524,56.086561713501446,19.608535116225198
6,2020-11-03,51000.0,-500.0,1913867,641943,594233,47710,124029,688719,-564690,516980,1147895,630915,59.97778320019103,9.688248044099055,32.96545684731489,-23.121104866186556
7,2020-11-02,51500.0,1000.0,1651148,610442,551505,58937,246486,219283,27203,-86140,794220,880360,48.10107876459288,-11.87670443559815,53.31805507440883,20.352598227093942
8,2020-10-30,50500.0,-2500.0,2559004,611919,510196,101723,564844,872220,-307376,205653,1382241,1176588,54.014804197257995,5.913725432665117,45.97835720459991,-7.339697869808923
9,2020-10-29,53000.0,-800.0,3225860,1122414,688516,433898,441476,899187,-457711,23813,1661970,1638157,51.52021476443491,-2.4945894328230835,50.782024018401295,4.803666813801385
10,2020-10-28,53800.0,900.0,3567700,1192863,700515,492348,525768,811319,-285551,-206797,1849069,2055866,51.82804047425512,0.3078257098202073,57.62440788182863,6.842383863427337
11,2020-10-27,52900.0,4950.0,9347585,3709950,1460370,2249580,1925433,895352,1030081,-3279661,3712202,6991863,39.71295259684721,-12.115087877407909,74.7986030616464,17.174195179817772
12,2020-10-26,47950.0,1700.0,3113034,1650255,1021061,629194,415466,567957,-152491,-476703,1047313,1524016,33.642838465625495,-6.070114131221715,48.955970284937464,-25.84263277670894
13,2020-10-23,46250.0,1050.0,1851587,793491,528010,265481,290625,505533,-214908,-50573,767471,818044,41.44936208776579,7.806523622140297,44.18069472295928,-4.775275561978184
14,2020-10-22,45200.0,-250.0,1650240,545273,772615,-227342,468115,310942,157173,70169,636852,566683,38.59147760325771,-2.8578844845080837,34.33942941632732,-9.84126530663196
15,2020-10-21,45450.0,-1400.0,2311018,820292,1009081,-188789,270674,600449,-329775,518564,1220052,701488,52.79283848070418,14.201360877446469,30.354069072590523,-3.9853603437367973
16,2020-10-20,46850.0,150.0,4399855,2062669,1605427,457242,556868,879252,-322384,-134858,1780318,1915176,40.46310617054426,-12.329732310159919,43.528161723511346,13.174092650920823
17,2020-10-19,46700.0,-450.0,1536628,456107,511234,-55127,245692,302622,-56930,112057,834829,722772,54.32863386584131,13.865527695297054,47.036237788195976,3.50807606468463
18,2020-10-16,47150.0,-1750.0,2521703,490752,1305961,-815209,253838,321559,-67721,882930,1777113,894183,70.47273211793777,16.144098252096455,35.459489083369455,-11.576748704826521
19,2020-10-15,48900.0,-250.0,1242544,342726,515528,-172802,220952,150412,70540,102262,678866,576604,54.63516784918683,-15.837564268750938,46.40511724333303,10.945628159963576
20,2020-10-14,49150.0,-1150.0,1954410,308347,665682,-357335,518675,632435,-113760,471095,1127388,656293,57.684313936175116,3.049146086988287,33.58010857496636,-12.82500866836667
21,2020-10-13,50300.0,600.0,2299747,746421,871289,-124868,454996,282358,172638,-47770,1098330,1146100,47.75873172135891,-9.925582214816203,49.83591673344937,16.255808158483013
22,2020-10-12,49700.0,-1200.0,2479740,734873,659269,75604,437918,1049363,-611445,535841,1306949,771108,52.705081984401595,4.946350263042682,31.096324614677346,-18.739592118772027
23,2020-10-08,50900.0,600.0,2672889,777736,1165470,-387734,1006725,464026,542699,-154965,888428,1043393,33.238492133418184,-19.46658985098341,39.03615151994714,7.939826905269793
24,2020-10-07,50300.0,-300.0,2181955,645753,444769,200984,224326,747647,-523321,322337,1311876,989539,60.1238797317085,26.885387598290315,45.35102694601859,6.314875426071453
25,2020-10-06,50600.0,100.0,3120855,781317,722058,59259,515706,802080,-286374,227115,1823832,1596717,58.440139000370095,-1.6837407313384034,51.16280634633779,5.811779400319196
26,2020-10-05,50500.0,3600.0,4185612,1473196,709214,763982,839450,485918,353532,-1117514,1872966,2990480,44.74772148015631,-13.692417520213787,71.44666060781553,20.283854261477742
27,2020-09-29,46900.0,1400.0,1721133,785445,461794,323651,304554,577705,-273151,-50500,631134,681634,36.66968212218347,-8.078039357972841,39.6037958716729,-31.84286473614263
28,2020-09-28,45500.0,1500.0,1378684,628357,369544,258813,85893,376993,-291100,32287,664434,632147,48.19334960005339,11.523667477869921,45.8514786564579,6.247682784784999
29,2020-09-25,44000.0,-550.0,1776722,730677,634802,95875,206485,429402,-222917,127042,839560,712518,47.25331256099716,-0.9400370390562287,40.1029536415939,-5.748525014864001
30,2020-09-24,44550.0,-1450.0,1801827,704962,635452,69510,226477,392494,-166017,96507,870388,773881,48.30585844256968,1.0525458815725202,42.94979484711906,2.846841205525159
31,2020-09-23,46000.0,-300.0,2303855,884368,861749,22619,327095,526041,-198946,176327,1092392,916065,47.41583129146583,-0.8900271511038511,39.762268024680374,-3.1875268224386843
32,2020-09-22,46300.0,-2150.0,2512697,834619,818769,15850,179407,552426,-373019,357169,1498671,1141502,59.64392045678408,12.228089165318252,45.42935339995232,5.667085375271945
33,2020-09-21,48450.0,650.0,3041594,1057073,882711,174362,345084,684122,-339038,164676,1639437,1474761,53.90058633729551,-5.743334119488573,48.48645151193749,3.0570981119851695
34,2020-09-18,47800.0,-700.0,2291761,788389,615811,172578,337051,634038,-296987,124409,1166321,1041912,50.89191237655235,-3.0086739607431596,45.463379471070496,-3.0230720408669924
35,2020-09-17,48500.0,1750.0,6283484,1896650,1636577,260073,710759,649711,61048,-321121,3676075,3997196,58.50376956478285,7.611857188230502,63.614326064966505,18.15094659389601
36,2020-09-16,46750.0,2100.0,4289868,1606866,983170,623696,881710,459238,422472,-1046168,1801292,2847460,41.989450491250544,-16.514319073532306,66.37640132516897,2.762075260202465
37,2020-09-15,44650.0,250.0,2173691,815238,499422,315816,467196,408324,58872,-374688,891257,1265945,41.00200994529581,-0.9874405459547333,58.239418574213175,-8.136982750955795
38,2020-09-14,44400.0,2100.0,2473674,783730,557084,226646,649761,420389,229372,-456018,1040183,1496201,42.05012463242934,1.048114687133527,60.484970937965144,2.245552363751969
39,2020-09-11,42300.0,150.0,784409,240287,283948,-43661,196426,180248,16178,27483,347696,320213,44.325855516701104,2.2757308842717663,40.82219862342222,-19.662772314542927
40,2020-09-10,42150.0,50.0,1182951,487414,560298,-72884,375755,299502,76253,-3369,319782,323151,27.03256516964777,-17.293290347053333,27.317361412264752,-13.504837211157465
41,2020-09-09,42100.0,-200.0,1352778,342415,467713,-125298,604958,548569,56389,68909,405405,336496,29.968331832717567,2.9357666630697956,24.874443552452803,-2.442917859811949
42,2020-09-08,42300.0,0.0,1018948,354743,470813,-116070,315332,205787,109545,6525,348873,342348,34.238547992635546,4.270216159917979,33.59818165401964,8.723738101566838
43,2020-09-07,42300.0,150.0,875590,295382,327549,-32167,277442,180325,97117,-64950,302766,367716,34.578512774243656,0.33996478160810994,41.996368163181394,8.398186509161754
44,2020-09-04,42150.0,-550.0,1510688,488692,693309,-204617,567342,189161,378181,-173564,454654,628218,30.09582388951259,-4.482688884731065,41.58489377025567,-0.41147439292572585
45,2020-09-03,42700.0,500.0,1405908,435398,450181,-14783,503444,476600,26844,-12061,467066,479127,33.221661730355045,3.125837840842454,34.07954147782074,-7.505352292434928
46,2020-09-02,42200.0,-950.0,1776692,503508,642517,-139009,208501,488904,-280403,419412,1064683,645271,59.92501795471584,26.703356224360796,36.31867538098894,2.2391339031682023
47,2020-09-01,43150.0,700.0,1787286,699961,718034,-18073,489801,547508,-57707,75780,597524,521744,33.431918562557975,-26.493099392157866,29.191970395336842,-7.1267049856521005
48,2020-08-31,42450.0,-300.0,2765135,1213994,700132,513862,476026,1013895,-537869,24007,1075115,1051108,38.881103454261726,5.4491848917037515,38.01289991266249,8.820929517325649
49,2020-08-28,42750.0,550.0,2038560,703846,514323,189523,291139,320768,-29629,-159894,1043575,1203469,51.191772623812895,12.310669169551169,59.03525037281218,21.02235046014969
50,2020-08-27,42200.0,-1000.0,1517260,435376,604341,-168965,432813,297436,135377,33588,649071,615483,42.77915452855806,-8.412618095254835,40.56542715157587,-18.46982322123631
51,2020-08-26,43200.0,200.0,1613088,504171,644421,-140250,394152,376275,17877,122373,714765,592392,44.310353805868004,1.5311992773099448,36.724096887460576,-3.8413302641152924
52,2020-08-25,43000.0,1450.0,2755909,1023376,754431,268945,400313,582125,-181812,-87133,1332220,1419353,48.34049310046159,4.030139294593589,51.50217224153628,14.778075354075703
53,2020-08-24,41550.0,800.0,1804120,540771,458792,81979,671507,738501,-66994,-14985,591842,606827,32.80502405604949,-15.535469044412103,33.635622907567125,-17.866549333969154
54,2020-08-21,40750.0,500.0,1815543,533752,617598,-83846,660158,443201,216957,-133111,621633,754744,34.23950851067697,1.43448445462748,41.57125444013168,7.935631532564557
55,2020-08-20,40250.0,-2050.0,2611942,556318,755426,-199108,783927,467375,316552,-117444,1271697,1389141,48.68779628337842,14.448287772701448,53.18422078285047,11.612966342718785
56,2020-08-19,42300.0,-400.0,2489110,583620,500655,82965,719004,1200386,-481382,398417,1186486,788069,47.66707779085697,-1.0207184925214463,31.66067389548875,-21.523546887361718
57,2020-08-18,42700.0,-1700.0,1896768,654489,550531,103958,584901,413733,171168,-275126,657378,932504,34.657796841785604,-13.009280949071368,49.16278638188751,17.502112486398758
58,2020-08-14,44400.0,-500.0,1557534,641638,408921,232717,262312,388421,-126109,-106608,653584,760192,41.962743670443146,7.304946828657542,48.807409661683145,-0.3553767202043616
59,2020-08-13,44900.0,-350.0,2245671,654340,773127,-118787,696845,687140,9705,109082,894486,785404,39.83156927261384,-2.131174397829305,34.97413467956793,-13.833274982115213
60,2020-08-12,45250.0,-1950.0,2734266,823684,731713,91971,432065,855874,-423809,331838,1478517,1146679,54.073634386705606,14.242065114091766,41.93736088588309,6.963226206315156
61,2020-08-11,47200.0,850.0,3721633,1002963,1006824,-3861,654226,677847,-23621,27482,2064444,2036962,55.47145567550589,1.3978212888002801,54.733016393610015,12.795655507726927
62,2020-08-10,46350.0,4100.0,6774254,1960266,1926981,33285,1053606,336519,717087,-750372,3760382,4510754,55.50990559255676,0.03844991705087608,66.58672674511466,11.853710351504645
63,2020-08-07,42250.0,100.0,2249386,710294,722111,-11817,518811,317106,201705,-189888,1020281,1210169,45.358199971014315,-10.151705621542447,53.79997030300713,-12.786756442107531
64,2020-08-06,42150.0,1050.0,2504981,982331,743144,239187,194632,220832,-26200,-212987,1328018,1541005,53.01509272924625,7.656892758231933,61.51763226946632,7.71766196645919
65,2020-08-05,41100.0,-50.0,1501565,407769,442633,-34864,326969,284323,42646,-7782,766827,774609,51.068518512352114,-1.9465742168941347,51.58677779516704,-9.93085447429928
66,2020-08-04,41150.0,1450.0,1998358,774198,478835,295363,412404,410301,2103,-297466,811756,1109222,40.62114996412055,-10.447368548231566,55.50667097687201,3.919893181704971
67,2020-08-03,39700.0,-700.0,1823829,644061,476288,167773,172019,426598,-254579,86806,1007749,920943,55.25457704642266,14.633427082302113,50.495029961690484,-5.0116410151815245
68,2020-07-31,40400.0,-300.0,1812196,597524,597003,521,339140,371741,-32601,32080,875532,843452,48.313317102565065,-6.941259943857595,46.543089158126385,-3.9519408035640993
69,2020-07-30,40700.0,1050.0,2577431,825165,680125,145040,92003,120138,-28135,-116905,1660263,1777168,64.41541985023072,16.102102747665654,68.95113778021603,22.408048622089645
70,2020-07-29,39650.0,1950.0,3410420,1221876,783747,438129,825960,142026,683934,-1122063,1362584,2484647,39.95355410770521,-24.46186574252551,72.85457509632245,3.9034373161064195
71,2020-07-28,37700.0,0.0,1698056,688806,612846,75960,303175,151635,151540,-227500,706075,933575,41.58137305247884,1.6278189447736295,54.97904662743749,-17.87552846888496
72,2020-07-27,37700.0,800.0,2159629,833515,683263,150252,563202,318454,244748,-395000,762912,1157912,35.32606757919994,-6.255305473278895,53.616246123755516,-1.3628005036819744
73,2020-07-24,36900.0,200.0,2719769,1205263,798151,407112,503882,282787,221095,-628207,1010624,1638831,37.158449853645656,1.8323822744457132,60.256257057125076,6.64001093336956
74,2020-07-23,36700.0,900.0,2882165,1162443,1032237,130206,404228,491795,-87567,-42639,1315494,1358133,45.64256383656036,8.484113982914707,47.12197254494451,-13.134284512180564
75,2020-07-22,35800.0,-900.0,2156629,650103,720202,-70099,390336,365052,25284,44815,1116190,1071375,51.75623623720167,6.113672400641306,49.678224673784875,2.556252128840363
76,2020-07-21,36700.0,-1300.0,3208266,642857,649176,-6319,241100,1072137,-831037,837356,2324309,1486953,72.44751526213848,20.69127902493681,46.34755970982456,-3.3306649639603165
77,2020-07-20,38000.0,1200.0,2899647,772725,690159,82566,682177,237099,445078,-527644,1444745,1972389,49.82485799133481,-22.62265727080367,68.02169367512666,21.674133965302097
78,2020-07-17,36800.0,1500.0,2720640,883863,469974,413889,393217,177617,215600,-629489,1443560,2073049,53.0595742178311,3.234716226496289,76.19710803340391,8.175414358277251
79,2020-07-16,35300.0,100.0,1891487,760909,560589,200320,343578,331415,12163,-212483,787000,999483,41.60747602283283,-11.452098194998271,52.84112446979545,-23.355983563608454
80,2020-07-15,35200.0,1200.0,2955272,1022038,582386,439652,512514,379956,132558,-572210,1420720,1992930,48.07408590478304,6.4666098819502125,67.43643224718402,14.595307777388562
81,2020-07-14,34000.0,200.0,1413638,399714,509257,-109543,286326,222507,63819,45724,727598,681874,51.469895404622676,3.395809499839636,48.23540397187965,-19.201028275304367
82,2020-07-13,33800.0,1750.0,1924926,591555,314222,277333,700257,169844,530413,-807746,633114,1440860,32.890303315556025,-18.57959208906665,74.85274758614098,26.61734361426133
83,2020-07-10,32050.0,-450.0,1064282,310667,510597,-199930,100466,231334,-130868,330798,653149,322351,61.36991887488467,28.479615559328643,30.28811912632178,-44.5646284598192
84,2020-07-09,32500.0,-350.0,1154644,413011,598299,-185288,212087,237743,-25656,210944,529546,318602,45.862274432638976,-15.507644442245692,27.593093628858767,-2.695025497463014
85,2020-07-08,32850.0,650.0,1704734,597730,399454,198276,630521,326441,304080,-502356,476483,978839,27.950577626773445,-17.91169680586553,57.41887004072189,29.825776411863124
86,2020-07-07,32200.0,-750.0,1771225,421678,533369,-111691,419638,729180,-309542,421233,929909,508676,52.500896272353884,24.55031864558044,28.718881000437552,-28.69998904028434
87,2020-07-06,32950.0,800.0,1611615,444867,287535,157332,464723,350922,113801,-271133,702025,973158,43.560341644871755,-8.940554627482129,60.384024720544296,31.665143720106744
88,2020-07-03,32150.0,-50.0,916274,200831,171346,29485,154206,449610,-295404,265919,561237,295318,61.25209271462466,17.691751069752904,32.23031538600899,-28.153709334535307
89,2020-07-02,32200.0,0.0,1062611,320421,222657,97764,283034,504128,-221094,123330,459156,335826,43.21016816125562,-18.041924553369036,31.603851268243975,-0.6264641177650141
90,2020-07-01,32200.0,150.0,885004,341279,371735,-30456,232771,242711,-9940,40396,310954,270558,35.13588639147394,-8.074281769781685,30.57138724796724,-1.0324640202767341
91,2020-06-30,32050.0,-50.0,1193847,400605,247448,153157,301607,500455,-198848,45691,491635,445944,41.18073756519889,6.04485117372495,37.35353022623502,6.782142978267782
92,2020-06-29,32100.0,-950.0,1259626,311107,480722,-169615,159111,371864,-212753,382368,789408,407040,62.67003062813883,21.489293062939943,32.31435362559998,-5.039176600635045
93,2020-06-26,33050.0,500.0,1329381,469515,385747,83768,323501,389939,-66438,-17330,536365,553695,40.346973516245534,-22.3230571118933,41.650587754752024,9.336234129152047
94,2020-06-25,32550.0,-1200.0,1495320,331905,709389,-377484,170926,346929,-176003,553487,992489,439002,66.37301714683144,26.02604363058591,29.358398202391463,-12.292189552360561
95,2020-06-24,33750.0,1500.0,2345625,915199,607382,307817,390715,377906,12809,-320626,1039711,1360337,44.32554223288036,-22.047474913951085,57.99464961364242,28.63625141125096
96,2020-06-23,32250.0,-250.0,1553679,631571,712573,-81002,281587,393299,-111712,192714,640521,447807,41.22608338015768,-3.0994588527226767,28.822362920526057,-29.172286693116366
97,2020-06-22,32500.0,-550.0,1231961,309196,586864,-277668,364341,275573,88768,188900,558424,369524,45.328058274572,4.101974894414319,29.99478067893383,1.1724177584077715
98,2020-06-19,33050.0,-350.0,1486816,432570,643814,-211244,468079,572895,-104816,316060,586167,270107,39.42431343219336,-5.903744842378643,18.166807459699115,-11.827973219234714
99,2020-06-18,33400.0,150.0,1287718,581920,510709,71211,261433,198443,62990,-134201,444365,578566,34.50794350937084,-4.916369922822518,44.92955755840953,26.762750098710413
100,2020-06-17,33250.0,-1000.0,1719716,486801,685637,-198836,258379,500306,-241927,440763,974536,533773,56.668426647190586,22.160483137819746,31.038438905028503,-13.891118653381024
101,2020-06-16,34250.0,2050.0,1866950,677401,471623,205778,504064,563197,-59133,-146645,685485,832130,36.716837622860815,-19.95158902432977,44.57162752082273,13.533188615794227
102,2020-06-15,32200.0,-2800.0,2407518,493442,1014732,-521290,447895,535341,-87446,608736,1466181,857445,60.900105419772565,24.18326779691175,35.615310041295636,-8.956317479527094
103,2020-06-12,35000.0,-700.0,2008295,805818,744455,61363,267412,311764,-44352,-17011,935065,952076,46.560141811835415,-14.33996360793715,47.40717872623295,11.791868684937313
104,2020-06-11,35700.0,-400.0,2230100,668025,1178416,-510391,492241,319764,172477,337914,1069834,731920,47.972467602349674,1.4123257905142594,32.82005291242545,-14.587125813807496
105,2020-06-10,36100.0,-600.0,1597092,582659,563005,19654,217605,579584,-361979,342325,796828,454503,49.89242949059916,1.9199618882494889,28.45816020617472,-4.361892706250732
106,2020-06-09,36700.0,-750.0,2151648,694040,845948,-151908,522656,662751,-140095,292003,934952,642949,43.4528324335579,-6.4395970570412615,29.88169998066598,1.4235397744912603
107,2020-06-08,37450.0,900.0,2553633,825828,1192909,-367081,938958,326449,612509,-245428,788847,1034275,30.891165645180806,-12.561666788377096,40.5021003409652,10.620400360299218
108,2020-06-05,36550.0,550.0,1795559,831991,579556,252435,306921,490526,-183605,-68830,656647,725477,36.57061672715851,5.679451081977703,40.40396333398123,-0.09813700698396843
109,2020-06-04,36000.0,-800.0,2735073,999632,904773,94859,441228,765688,-324460,229601,1294213,1064612,47.319139196650326,10.748522469491817,38.92444552668247,-1.4795178072987625
110,2020-06-03,36800.0,300.0,3786425,1414811,1081158,333653,428417,1186538,-758121,424468,1943197,1518729,51.32009745340261,4.000958256752284,40.109839756498545,1.185394229816076
111,2020-06-02,36500.0,1900.0,3154171,1100976,868719,232257,838896,390528,448368,-680625,1214299,1894924,38.49819810022982,-12.821899353172789,60.076768190437356,19.96692843393881
112,2020-06-01,34600.0,350.0,2524579,757764,833392,-75628,660123,440293,219830,-144202,1106692,1250894,43.83669514798309,5.338497047753272,49.54861780914758,-10.528150381289777
113,2020-05-29,34250.0,2150.0,5053078,1108124,1011961,96163,2530855,1302430,1228425,-1324588,1414099,2738687,27.984903458842314,-15.851791689140779,54.198391554612854,4.649773745465275
114,2020-05-28,32100.0,150.0,2215603,616145,516099,100046,806867,535799,271068,-371114,792591,1163705,35.77315069531861,7.788247236476298,52.52317314970236,-1.6752184049104955
115,2020-05-27,31950.0,450.0,2250605,883010,488260,394750,330082,370169,-40087,-354663,1037513,1392176,46.09929330113459,10.326142605815974,61.857855998720346,9.334682849017987
116,2020-05-26,31500.0,1100.0,2664764,992263,390599,601664,472160,457849,14311,-615975,1200341,1816316,45.04492705545407,-1.0543662456805194,68.1604825042668,6.302626505546449
117,2020-05-25,30400.0,300.0,1126618,403309,501804,-98495,134261,121355,12906,85589,589048,503459,52.28462531221763,7.23969825676356,44.68764035369575,-23.472842150571047
118,2020-05-22,30100.0,-500.0,1764649,412141,785080,-372939,485834,400306,85528,287411,866674,579263,49.11310974590414,-3.171515566313488,32.825961423489886,-11.861678930205862
119,2020-05-21,30600.0,-250.0,2071411,621773,494289,127484,155814,846838,-691024,563540,1293824,730284,62.460998807093326,13.347889061189186,35.25538871812498,2.429427294635097
120,2020-05-20,30850.0,-850.0,1969201,566289,532429,33860,156264,711477,-555213,521353,1246648,725295,63.307300778335986,0.84630197124266,36.83194351414609,1.5765547960211066
121,2020-05-19,31700.0,2350.0,5443583,2332154,809983,1522171,1699549,1254142,445407,-1967578,1411880,3379458,25.936593600207804,-37.370707178128185,62.08150036474138,25.24955685059529
122,2020-05-18,29350.0,250.0,1708727,572386,502622,69764,771899,722088,49811,-119575,364442,484017,21.328275376932652,-4.608318223275152,28.326174982896624,-33.755325381844756
123,2020-05-15,29100.0,400.0,1261825,487041,358538,128503,287516,378875,-91359,-37144,487268,524412,38.61613139698453,17.287856020051876,41.559804251778175,13.23362926888155
124,2020-05-14,28700.0,-1000.0,2081307,570091,924621,-354530,321268,764395,-443127,797657,1189948,392291,57.17311285648874,18.556981459504215,18.848300611106385,-22.71150364067179
125,2020-05-13,29700.0,0.0,1311883,378666,337313,41353,366692,448930,-82238,40885,566525,525640,43.18411016836105,-13.989002688127691,40.067597491544596,21.21929688043821
126,2020-05-12,29700.0,-850.0,1967011,307890,549660,-241770,466840,778185,-311345,553115,1192281,639166,60.61384506746531,17.42973489910426,32.49427684949398,-7.573320642050618
127,2020-05-11,30550.0,50.0,2487579,799752,673832,125920,519897,531174,-11277,-114643,1167930,1282573,46.950468708732465,-13.663376358732847,51.55908616369571,19.06480931420173
128,2020-05-08,30500.0,1500.0,2777232,978595,404936,573659,920887,211004,709883,-1283542,877750,2161292,31.60520979161986,-15.345258917112606,77.821802427741,26.262716264045295
129,2020-05-07,29000.0,-150.0,1333680,592443,350721,241722,191005,590878,-399873,158151,550232,392081,41.25667326495111,9.651463473331251,29.398431407833964,-48.42337101990704
130,2020-05-06,29150.0,450.0,1579421,515264,280782,234482,510832,678501,-167669,-66813,553325,620138,35.0334078121033,-6.223265452847812,39.26362888678826,9.865197478954297
131,2020-05-04,28700.0,-950.0,1876049,459305,448996,10309,582666,1040184,-457518,447209,834078,386869,44.45928651117322,9.42587869906992,20.621476304723384,-18.642152582064877
132,2020-04-29,29650.0,400.0,1875521,412378,377176,35202,911028,795388,115640,-150842,552115,702957,29.437953507318763,-15.021333003854455,37.48062538356009,16.859149078836705
133,2020-04-28,29250.0,650.0,2172224,777029,399751,377278,537906,521661,16245,-393523,857289,1250812,39.46595747031614,10.028003962997378,57.58209098140892,20.10146559784883
134,2020-04-27,28600.0,900.0,1374350,501485,199092,302393,269367,283285,-13918,-288475,603498,891973,43.911521810310326,4.445564339994185,64.90144431913268,7.319353337723761
135,2020-04-24,27700.0,-1100.0,2200412,324752,1095778,-771026,211337,422798,-211461,982487,1664323,681836,75.63688072960882,31.725358919298493,30.986742482771408,-33.914701836361274
136,2020-04-23,28800.0,400.0,1963345,832070,406543,425527,299293,366982,-67689,-357838,831982,1189820,42.37574140051799,-33.26113932909083,60.60167723960893,29.614934756837524
137,2020-04-22,28400.0,-450.0,2420355,485863,598232,-112369,322097,778664,-456567,568936,1612395,1043459,66.61812006916341,24.242378668645422,43.111816241832294,-17.48986099777664
138,2020-04-21,28850.0,-500.0,2441841,360238,691642,-331404,601225,758277,-157052,488456,1480378,991922,60.625487081263685,-5.992632987899725,40.62189143355362,-2.4899248082786727
139,2020-04-20,29350.0,-550.0,1597338,297413,501139,-203726,179540,403813,-224273,427999,1120385,692386,70.1407591880992,9.51527210683551,43.346242310644335,2.724350877090714
140,2020-04-17,29900.0,900.0,1965039,387695,299045,88650,572741,605279,-32538,-56112,1004603,1060715,51.12381993436262,-19.016939253736574,53.97933577908633,10.633093468441992
141,2020-04-16,29000.0,-850.0,2289317,376750,368391,8359,521245,1224472,-703227,694868,1391322,696454,60.77454542118894,9.650725486826317,30.42191186279576,-23.557423916290567
142,2020-04-14,29850.0,350.0,1717972,387980,242399,145581,304825,659603,-354778,209197,1025167,815970,59.673091296016466,-1.1014541251724737,47.49611751530293,17.074205652507167
143,2020-04-13,29500.0,-1500.0,2007475,305734,490971,-185237,202464,444652,-242188,427425,1499277,1071852,74.68471587441937,15.011624578402902,53.39304349991906,5.896925984616132
144,2020-04-10,31000.0,850.0,2293372,266371,509354,-242983,202870,415662,-212792,455775,1824131,1368356,79.5392548614006,4.854538986981225,59.66568005539441,6.272636555475351
145,2020-04-09,30150.0,1900.0,3167177,1130973,623936,507037,261974,629863,-367889,-139148,1774230,1913378,56.0192878389809,-23.519967022419692,60.41272716996872,0.7470471145743076
146,2020-04-08,28250.0,0.0,2550320,591367,466652,124715,681564,1050951,-369387,244672,1277389,1032717,50.08740079676276,-5.931887042218143,40.49362432949591,-19.91910284047281
147,2020-04-07,28250.0,1450.0,2680220,563825,425412,138413,573679,837909,-264230,125817,1542716,1416899,57.55930483318533,7.471904036422572,52.86502600532792,12.371401675832011
148,2020-04-06,26800.0,1400.0,1721874,580493,182346,398147,255646,505784,-250138,-148009,885735,1033744,51.44017506507444,-6.119129768110888,60.03598404993629,7.170958044608369
149,2020-04-03,25400.0,-400.0,1461529,296073,384717,-88644,273491,546319,-272828,361472,891965,530493,61.02957929675018,9.589404231675736,36.29712444980565,-23.73885960013064
150,2020-04-02,25800.0,250.0,1658336,476704,442255,34449,411889,602830,-190941,156492,769743,613251,46.41658867684233,-14.612990619907848,36.97990033382861,0.6827758840229592
151,2020-04-01,25550.0,-450.0,2170012,467630,516884,-49254,346919,722629,-375710,424964,1355463,930499,62.46338729924075,16.04679862239842,42.879901124970736,5.900000791142126
152,2020-03-31,26000.0,1050.0,2219339,366941,454821,-87880,947361,790963,156398,-68518,905037,973555,40.779574458881676,-21.683812840359074,43.86689009655578,0.986988971585042
153,2020-03-30,24950.0,-550.0,1986835,437634,516642,-79008,710360,859483,-149123,228131,838841,610710,42.219962905827614,1.4403884469459385,30.737831777676554,-13.129058318879224
154,2020-03-27,25500.0,450.0,2820545,589991,609373,-19382,831730,910843,-79113,98495,1398824,1300329,49.59410326727636,7.374140361448745,46.10204765391086,15.364215876234304
155,2020-03-26,25050.0,-100.0,3897513,896098,936901,-40803,680865,1395083,-714218,755021,2320550,1565529,59.539249772867976,9.945146505591616,40.16738366235084,-5.934663991560022
156,2020-03-25,25150.0,2050.0,5010440,1351149,871734,479415,791693,1786968,-995275,515860,2867598,2351738,57.23245862638811,-2.306791146479867,46.93675605336058,6.769372391009746
157,2020-03-24,23100.0,1600.0,2947942,739852,500265,239587,625247,1283765,-658518,418931,1582843,1163912,53.69315271467349,-3.539305911714621,39.48218791278797,-7.454568140572611
158,2020-03-23,21500.0,-2650.0,2365341,412327,646289,-233962,435458,991008,-555550,789512,1517556,728044,64.15802203572339,10.464869321049903,30.779663481925017,-8.702524430862955
159,2020-03-20,24150.0,1600.0,3015123,889084,787347,101737,787673,1305635,-517962,416225,1338366,922141,44.38843788462361,-19.769584151099778,30.58386009459647,-0.19580338732854585
160,2020-03-19,22550.0,-2750.0,2305074,844899,694023,150876,639252,841105,-201853,50977,820923,769946,35.613737346393215,-8.774700538230398,33.402224830959874,2.818364736363403
161,2020-03-18,25300.0,-50.0,2019043,267753,723451,-455698,1021174,672400,348774,106924,730116,623192,36.161488388310694,0.5477510419174791,30.865712122030093,-2.5365127089297808
162,2020-03-17,25350.0,-1750.0,2682844,529807,563319,-33512,754780,1289599,-534819,568331,1398257,829926,52.11846085720973,15.956972468899039,30.934560488794727,0.0688483667646338
163,2020-03-16,27100.0,-1750.0,1862674,390950,706031,-315081,692533,823536,-131003,446084,779191,333107,41.83185033988771,-10.286610517322025,17.88326889192634,-13.051291596868388
164,2020-03-13,28850.0,-1650.0,2777060,1173677,911139,262538,838231,1309148,-470917,208379,765152,556773,27.55259158966677,-14.27925875022094,20.049008663838734,2.1657397719123956
165,2020-03-12,30500.0,-1300.0,1872682,715118,781344,-66226,800126,738470,61656,4570,357438,352868,19.086956568173346,-8.465635021493423,18.84292154247224,-1.2060871213664939
166,2020-03-11,31800.0,-150.0,1512601,520309,682345,-162036,652952,516292,136660,25376,339340,313964,22.434204393623965,3.3472478254506193,20.756564355041416,1.9136428125691758
167,2020-03-10,31950.0,-1050.0,1625705,520047,601686,-81639,522919,787110,-264191,345830,582739,236909,35.845310188502836,13.411105794878871,14.572693077772414,-6.183871277269002
168,2020-03-09,33000.0,-1650.0,1316550,373199,643846,-270647,492207,417764,74443,196204,451144,254940,34.2671375944704,-1.5781725940324378,19.36424746496525,4.791554387192836
169,2020-03-06,34650.0,-1250.0,1357464,364049,620979,-256930,478353,577611,-99258,356188,515062,158874,37.94295833996335,3.675820745492949,11.703735789678401,-7.660511675286848
170,2020-03-05,35900.0,150.0,963826,415855,547080,-131225,199374,319490,-120116,251341,348597,97256,36.168042779505846,-1.7749155604575009,10.090618016114943,-1.6131177735634576
171,2020-03-04,35750.0,850.0,1614490,452025,544053,-92028,897345,817892,79453,12575,265120,252545,16.421284740072718,-19.74675803943313,15.642401005890406,5.551782989775463
172,2020-03-03,34900.0,400.0,1411743,460756,618928,-158172,602484,532468,70016,88156,348503,260347,24.686008714050644,8.264723973977926,18.441529371847427,2.7991283659570207
173,2020-03-02,34500.0,-1750.0,2981038,731465,708742,22723,1648006,2073512,-425506,402783,601567,198784,20.179783015177936,-4.506225698872708,6.668281316776237,-11.773248055071189
174,2020-02-28,36250.0,-1450.0,1633356,649224,572621,76603,625667,695847,-70180,-6423,358465,364888,21.94653217057396,1.766749155396024,22.33977161133274,15.671490294556502
175,2020-02-27,37700.0,-450.0,1053667,563889,590604,-26715,348410,343825,4585,22130,141368,119238,13.416762601467067,-8.529769569106893,11.316478545878347,-11.023293065454393
176,2020-02-26,38150.0,0.0,1168647,630611,581404,49207,412395,466940,-54545,5338,125641,120303,10.750979551566896,-2.6657830499001705,10.294212024674689,-1.0222665212036581
177,2020-02-25,38150.0,-450.0,1407263,564586,571342,-6756,471345,728485,-257140,263896,371332,107436,26.386823216413706,15.63584366484681,7.634393855306364,-2.659818169368325
178,2020-02-24,38600.0,-1450.0,1185870,493281,461621,31660,408271,509072,-100801,69141,284318,215177,23.975477919164835,-2.4113452972488716,18.14507492389554,10.510681068589175
179,2020-02-21,40050.0,-500.0,971041,400042,382689,17353,403784,488509,-84725,67372,167215,99843,17.2201791685418,-6.755298750623034,10.282058121129797,-7.863016802765742
180,2020-02-20,40550.0,-750.0,1144520,522390,512998,9392,425615,515105,-89490,80098,196515,116417,17.170080033551184,-0.050099134990617245,10.17168769440464,-0.11037042672515618
181,2020-02-19,41300.0,-50.0,818025,317066,350315,-33249,353128,359085,-5957,39206,147831,108625,18.07169707527276,0.9016170417215754,13.27893401790899,3.1072463235043486
182,2020-02-18,41350.0,-100.0,809542,337521,417401,-79880,382972,285520,97452,-17572,89049,106621,10.99992341348565,-7.071773661787109,13.17053346213044,-0.1084005557785499
183,2020-02-17,41450.0,-200.0,776081,391484,295260,96224,204399,405758,-201359,105135,180198,75063,23.218968123172708,12.219044709687058,9.672057426995378,-3.4984760351350612
184,2020-02-14,41650.0,400.0,984696,472204,371358,100846,285876,330278,-44402,-56444,226616,283060,23.013803244859325,-0.20516487831338281,28.74592767717143,19.07387025017605
185,2020-02-13,41250.0,-400.0,951609,273582,609808,-336226,481038,181784,299254,36972,196989,160017,20.7006238906946,-2.313179354164724,16.81541473441298,-11.930512942758451
186,2020-02-12,41650.0,300.0,1012598,471322,346460,124862,312614,505070,-192456,67594,228662,161068,22.581715547532188,1.8810916568375866,15.906411033796235,-0.9090037006167435
187,2020-02-11,41350.0,700.0,1141865,594950,461779,133171,328539,429778,-101239,-31932,218376,250308,19.124502458696956,-3.457213088835232,21.92098015089349,6.014569117097256
188,2020-02-10,40650.0,150.0,701557,291930,429153,-137223,232024,167543,64481,72742,177603,104861,25.31554813080049,6.1910456721035345,14.94689668836602,-6.974083462527471
189,2020-02-07,40500.0,-800.0,1054261,402375,598766,-196391,360280,363516,-3236,199627,291606,91979,27.659754083666186,2.344205952865696,8.724499910363752,-6.222396778002269
190,2020-02-06,41300.0,1900.0,1405887,716378,503737,212641,458193,478838,-20645,-191996,231316,423312,16.453384944878216,-11.20636913878797,30.109959050762967,21.385459140399213
191,2020-02-05,39400.0,-850.0,1554328,483794,845316,-361522,550491,582201,-31710,393232,520043,126811,33.457738649757324,17.004353704879108,8.158573994678086,-21.95138505608488
192,2020-02-04,40250.0,150.0,1122184,482229,769101,-286872,389800,271575,118225,168647,250155,81508,22.291798849386556,-11.165939800370769,7.263336493837018,-0.895237500841068
193,2020-02-03,40100.0,-800.0,1428913,712281,683911,28370,493779,566246,-72467,44097,222853,178756,15.595981000942674,-6.695817848443882,12.509928876005747,5.246592382168728
194,2020-01-31,40900.0,-1050.0,1349571,448067,574837,-126770,648640,644036,4604,122166,252864,130698,18.73662074837115,3.140639747428475,9.684410823884035,-2.825518052121712
195,2020-01-30,41950.0,-600.0,1030375,329718,460717,-130999,400263,382118,18145,112854,300394,187540,29.153851753002545,10.417231004631397,18.201140361518863,8.516729537634829
196,2020-01-29,42550.0,-150.0,1025015,336240,577555,-241315,334758,267561,67197,174118,354017,179899,34.53773847211992,5.383886719117374,17.550865109291085,-0.6502752522277788
197,2020-01-28,42700.0,-700.0,1631227,648247,530841,117406,609577,783220,-173643,56237,373403,317166,22.890928117300657,-11.646810354819262,19.443400581280226,1.8925354719891416
198,2020-01-23,43400.0,800.0,2060957,658321,632725,25596,671836,627527,44309,-69905,730800,800705,35.45925509362883,12.568326976328176,38.85112595750421,19.407725376223983
199,2020-01-22,42600.0,1000.0,1435894,566777,344199,222578,334996,692707,-357711,135133,534121,398988,37.19780150902504,1.7385464153962076,27.7867307753915,-11.064395182112708
200,2020-01-21,41600.0,0.0,567421,196201,210994,-14793,96767,222534,-125767,140560,274453,133893,48.36849535001348,11.170693840988442,23.596765012221965,-4.1899657631695355
201,2020-01-20,41600.0,200.0,722748,257056,359278,-102222,142795,181880,-39085,141307,322897,181590,44.67629104473482,-3.692204305278665,25.124939813046872,1.5281748008249068
202,2020-01-17,41400.0,250.0,1016691,252916,413255,-160339,410748,381637,29111,131228,353027,221799,34.72313613477448,-9.95315490996034,21.815772933959284,-3.309166879087588
203,2020-01-16,41150.0,-50.0,1105472,295258,339314,-44056,271043,594549,-323506,367562,539171,171609,48.77292233543681,14.049786200662332,15.523595351126035,-6.292177582833249
204,2020-01-15,41200.0,50.0,920045,279916,322345,-42429,284202,432247,-148045,190474,355927,165453,38.685825149856804,-10.087097185580006,17.983142128917606,2.459546777791571
205,2020-01-14,41150.0,700.0,1412170,425828,463364,-37536,492900,677945,-185045,222581,493442,270861,34.94211036914819,-3.743714780708615,19.180481103549855,1.197338974632249
206,2020-01-13,40450.0,50.0,1299326,298128,404575,-106447,461296,770344,-309048,415495,539902,124407,41.55246643259659,6.6103560634484,9.574733361758327,-9.605747741791529
207,2020-01-10,40400.0,-350.0,1455064,379440,579077,-199637,465038,700776,-235738,435375,610586,175211,41.962827751906445,0.41036131930985675,12.04146346827356,2.466730106515234
208,2020-01-09,40750.0,-550.0,1908796,492233,781008,-288775,641097,943274,-302177,590952,775466,184514,40.62592335692237,-1.3369043949840744,9.666512293613357,-2.374951174660204
209,2020-01-08,41300.0,-750.0,997335,314553,511330,-196777,328360,327907,453,196324,354422,158098,35.53690585410118,-5.089017502821193,15.852045701795284,6.185533408181927
210,2020-01-07,42050.0,150.0,1124218,380695,429687,-48992,388617,563920,-175303,224295,354906,130611,31.569144062806327,-3.9677617912948513,11.617942427536295,-4.234103274258988
211,2020-01-06,41900.0,-100.0,830880,289787,401397,-111610,244156,318463,-74307,185917,296937,111020,35.73765164644714,4.168507583640814,13.361736953591375,1.7437945260550798
212,2020-01-03,42000.0,-500.0,1569720,470693,928299,-457606,451885,442760,9125,448481,647142,198661,41.2265881813317,5.488936534884559,12.655823968605867,-0.7059129849855079
213,2020-01-02,42500.0,-1800.0,1355029,400218,882003,-481785,262960,362971,-100011,581796,691851,110055,51.0580216364373,9.831433455105604,8.121966393339184,-4.533857575266683
214,2019-12-30,44300.0,-50.0,644977,232265,179526,52739,241221,398888,-157667,104928,171491,66563,26.58870006217276,-24.469321574264544,10.320212968834548,2.1982465754953644
215,2019-12-27,44350.0,-750.0,823367,339954,533442,-193488,191115,233283,-42168,235656,292298,56642,35.500329743601576,8.911629681428817,6.879313841822662,-3.4408991270118863
216,2019-12-26,45100.0,400.0,439661,316700,182190,134510,43218,36120,7098,-141608,79743,221351,18.137383120176683,-17.362946623424893,50.34583463168214,43.46652078985947
217,2019-12-24,44700.0,-50.0,482930,316870,220987,95883,65732,156517,-90785,-5098,100328,105426,20.774853498436627,2.6374703782599447,21.830493032116454,-28.515341599565684
218,2019-12-23,44750.0,50.0,564448,336016,328847,7169,109544,156534,-46990,39821,118888,79067,21.062701967231703,0.287848468795076,14.007844832473495,-7.822648199642959
219,2019-12-20,44700.0,0.0,751826,272771,279708,-6937,306026,399388,-93362,100299,173029,72730,23.014500695639683,1.9517987284079794,9.67378090143198,-4.3340639310415146
220,2019-12-19,44700.0,-550.0,729364,305651,322488,-16837,193249,362512,-169263,186100,230464,44364,31.59794012317581,8.583439427536128,6.082559599870572,-3.5912213015614087
221,2019-12-18,45250.0,600.0,780340,213059,376164,-163105,484886,219607,265279,-102174,82395,184569,10.558858958915344,-21.039081164260466,23.652382294897095,17.569822695026524
222,2019-12-17,44650.0,200.0,892679,370893,366233,4660,371719,429834,-58115,53455,150067,96612,16.810858102408595,6.251999143493251,10.822703345771547,-12.829678949125547
223,2019-12-16,44450.0,0.0,734662,389038,238334,150704,212395,435752,-223357,72653,133229,60576,18.134734068183736,1.3238759657751409,8.245424426470949,-2.577278919300598
224,2019-12-13,44450.0,-550.0,851436,338435,465781,-127346,287401,297729,-10328,137674,225600,87926,26.49641311854326,8.361679050359523,10.326789095128701,2.081364668657752
225,2019-12-12,45000.0,750.0,1837371,883172,963186,-80014,825900,633523,192377,-112363,128299,240662,6.98274872086258,-19.513664397680678,13.098171245763648,2.771382150634947
226,2019-12-11,44250.0,200.0,944325,328894,339141,-10247,494889,503212,-8323,18570,120542,101972,12.764884970746301,5.782136249883721,10.79840097424086,-2.299770271522789
227,2019-12-10,44050.0,700.0,628665,236352,242716,-6364,271425,247244,24181,-17817,120888,138705,19.22931927179022,6.464434301043919,22.06342010450717,11.26501913026631
228,2019-12-09,43350.0,-450.0,582117,244232,232997,11235,155660,301128,-145468,134233,182225,47992,31.30384441615689,12.074525144366667,8.244390732447258,-13.819029372059912
229,2019-12-06,43800.0,50.0,676997,240660,236882,3778,289880,395627,-105747,101969,146457,44488,21.633330723769824,-9.670513692387065,6.5713732852582805,-1.6730174471889772
230,2019-12-05,43750.0,800.0,1085604,419556,655463,-235907,513273,206487,306786,-70879,152775,223654,14.072811080283417,-7.560519643486407,20.601803235802375,14.030429950544095
231,2019-12-04,42950.0,-50.0,1177913,387168,429322,-42154,680143,661648,18495,23659,110602,86943,9.389657810042,-4.683153270241418,7.381105395729566,-13.220697840072809
232,2019-12-03,43000.0,350.0,943466,333837,585682,-251845,473115,292651,180464,71381,136514,65133,14.469413842152235,5.079756032110236,6.903587410675106,-0.47751798505445997
233,2019-12-02,42650.0,-600.0,1012449,436310,442272,-5962,323819,472515,-148696,154658,252320,97662,24.9217491448952,10.452335302742966,9.646115508040404,2.742528097365298
234,2019-11-29,43250.0,-1300.0,860224,384925,441322,-56397,194989,360318,-165329,221726,280310,58584,32.58569860873447,7.663949463839266,6.810319172680604,-2.8357963353598006
235,2019-11-28,44550.0,450.0,610036,293622,319922,-26300,185009,170074,14935,11365,131405,120040,21.540532034175033,-11.045166574559435,19.677527227901304,12.8672080552207
236,2019-11-27,44100.0,150.0,706936,332124,238643,93481,224430,404169,-179739,86258,150382,64124,21.272364117826793,-0.26816791634824,9.070693811038057,-10.606833416863248
237,2019-11-26,43950.0,-750.0,1600104,505641,284749,220892,713562,1259211,-545649,324757,380901,56144,23.804765190262632,2.532401072435839,3.508771929824561,-5.561921881213495
238,2019-11-25,44700.0,500.0,1007261,450607,276865,173742,416700,595581,-178881,5139,139954,134815,13.894511948740199,-9.910253241522433,13.384316478052858,9.875544548228296
239,2019-11-22,44200.0,500.0,1123670,490350,290231,200119,430390,582146,-151756,-48363,202930,251293,18.059572650333283,4.1650607015930845,22.363594293698327,8.97927781564547
240,2019-11-21,43700.0,-50.0,987570,518977,438619,80358,339064,452530,-113466,33108,129529,96421,13.115931022611054,-4.943641627722229,9.763459805380885,-12.600134488317442
241,2019-11-20,43750.0,250.0,955426,402566,392440,10126,506978,454630,52348,-62474,45882,108356,4.8022557476978855,-8.31367527491317,11.34111904009311,1.5776592347122254
242,2019-11-19,43500.0,-200.0,741012,367195,324753,42442,333766,358460,-24694,-17748,40051,57799,5.404905723524045,0.6026499758261599,7.80000863683719,-3.54111040325592
243,2019-11-18,43700.0,100.0,682054,284282,312658,-28376,360423,313059,47364,-18988,37349,56337,5.4759593815152465,0.07105365799120111,8.259903174821934,0.4598945379847441
244,2019-11-15,43600.0,100.0,624280,434629,314108,120521,146810,207798,-60988,-59533,42841,102374,6.862465560325496,1.386506178810249,16.398731338501953,8.138828163680019
245,2019-11-14,43500.0,700.0,1053067,580200,450851,129349,438474,477301,-38827,-90522,34393,124915,3.265984025707766,-3.5964815346177295,11.862018276140075,-4.536713062361878
246,2019-11-13,42800.0,-900.0,759668,287096,273032,14064,322993,402231,-79238,65174,149579,84405,19.690048810796295,16.42406478508853,11.110774706845621,-0.7512435692944539
247,2019-11-12,43700.0,750.0,724324,331314,241439,89875,326384,313895,12489,-102364,66626,168990,9.198369790314832,-10.491679020481463,23.330719401814655,12.219944694969033
248,2019-11-11,42950.0,-150.0,762692,421967,337728,84239,286227,354230,-68003,-16236,54498,70734,7.145479433375465,-2.0528903569393666,9.274254876149218,-14.056464525665437
249,합계,,,471267350,154027565,145008517,9019048,113696550,131819388,-18122838,9103790,203543235,194439445,43.1906082608948,36.045128827519335,41.258840655946145,31.984585779796927
