,날짜,종가,대비,거래량,기관 매수,기관 매도,기관 순매수,외국인 매수,외국인 매도,외국인 순매수,개인 순매수,개인 매수,개인 매도,개인매수비율(%),개인매수비율증가(%p),개인매도비율(%),개인매도비율증가(%p)
0,2020-11-11,801000.0,4000.0,116090,32253,32343,-90,21385,52488,-31103,31193,62452,31259,53.79619260918253,,26.926522525626666,
1,2020-11-10,797000.0,-47000.0,172812,33893,52889,-18996,25203,92504,-67301,86297,113716,27419,65.80330069671088,12.007108087528344,15.866375020253223,-11.060147505373443
2,2020-11-09,844000.0,-4000.0,71482,26258,25175,1083,22899,27343,-4444,3361,22325,18964,31.231638734226795,-34.571661962484086,26.52975574270446,10.663380722451237
3,2020-11-06,848000.0,5000.0,91315,25452,24817,635,40445,32131,8314,-8949,25418,34367,27.83551442807863,-3.3961243061481667,37.635656792421834,11.105901049717374
4,2020-11-05,843000.0,6000.0,108701,37300,31764,5536,44880,34181,10699,-16235,26521,42756,24.398119612515064,-3.4373948155635645,39.33358478762845,1.6979279952066193
5,2020-11-04,837000.0,55000.0,197108,76785,28129,48656,76545,21262,55283,-103939,43778,147717,22.210158897660165,-2.187960714854899,74.94216368691275,35.608578899284296
6,2020-11-03,782000.0,4000.0,48350,25139,13316,11823,7721,23692,-15971,4148,15490,11342,32.037228541882115,9.82706964422195,23.458117890382628,-51.484045796530125
7,2020-11-02,778000.0,2000.0,48696,28815,16874,11941,8546,21217,-12671,730,11335,10605,23.27706587810087,-8.760162663781244,21.777969443075406,-1.6801484473072215
8,2020-10-30,776000.0,-37000.0,92285,29992,21483,8509,28033,52083,-24050,15541,34260,18719,37.12412634772715,13.847060469626278,20.283903126185187,-1.494066316890219
9,2020-10-29,813000.0,11000.0,88029,45077,21446,23631,27142,28452,-1310,-22321,15810,38131,17.95999045769008,-19.16413589003707,43.31640709311704,23.032503966931856
10,2020-10-28,802000.0,20000.0,78286,36108,19881,16227,28031,37302,-9271,-6956,14147,21103,18.070919449199092,0.11092899150901303,26.956288480698976,-16.360118612418066
11,2020-10-27,782000.0,-14000.0,81633,32460,20860,11600,25839,44472,-18633,7033,23334,16301,28.5840285178788,10.513109068679707,19.968640133279433,-6.987648347419544
12,2020-10-26,796000.0,0.0,49132,31654,16809,14845,5230,13194,-7964,-6881,12248,19129,24.92876333143369,-3.65526518644511,38.93389237157046,18.965252238291026
13,2020-10-23,796000.0,-15000.0,80718,35848,24972,10876,18669,39267,-20598,9722,26201,16479,32.459922198270526,7.5311588668368366,20.41552070170222,-18.518371669868237
14,2020-10-22,811000.0,2000.0,85163,39422,13211,26211,28275,32822,-4547,-21664,17466,39130,20.50890644998415,-11.951015748286377,45.947183636086095,25.531662934383874
15,2020-10-21,809000.0,15000.0,108005,44629,11936,32693,41596,41193,403,-33096,21780,54876,20.16573306791352,-0.34317338207062775,50.80875885375677,4.861575217670676
16,2020-10-20,794000.0,23000.0,147983,49328,20712,28616,75761,46669,29092,-57708,22894,80602,15.470695958319535,-4.6950371095939865,54.467067163120085,3.6583083093633135
17,2020-10-19,771000.0,4000.0,105467,30951,15743,15208,54477,41059,13418,-28626,20039,48665,19.000256004247774,3.529560045928239,46.14239525159529,-8.324671911524796
18,2020-10-16,767000.0,17000.0,135943,29891,25896,3995,82922,37315,45607,-49602,23130,72732,17.014484011681365,-1.9857719925664092,53.5018353280419,7.35944007644661
19,2020-10-15,750000.0,-2000.0,72571,11613,25525,-13912,35800,21493,14307,-395,25158,25553,34.66674015791432,17.652256146232954,35.2110347108349,-18.290800617206997
20,2020-10-14,752000.0,-2000.0,94309,11449,13192,-1743,60462,62969,-2507,4250,22398,18148,23.749589116627256,-10.917151041287063,19.243126318803082,-15.96790839203182
21,2020-10-13,754000.0,0.0,77742,11505,22447,-10942,35498,35489,9,10933,30739,19806,39.53975971804173,15.790170601414474,25.476576367986414,6.2334500491833325
22,2020-10-12,754000.0,3000.0,123601,16311,21852,-5541,67209,63569,3640,1901,40081,38180,32.42773116722357,-7.1120285508181595,30.889717720730413,5.413141352743999
23,2020-10-08,751000.0,-17000.0,226092,30005,65384,-35379,85927,121787,-35860,71239,110160,38921,48.72352847513402,16.295797307910448,17.214673672664222,-13.67504404806619
24,2020-10-07,768000.0,-20000.0,172973,30243,64766,-34523,22562,72781,-50219,84742,120168,35426,69.47211414498217,20.748585669848154,20.480653049897963,3.265979377233741
25,2020-10-06,788000.0,-1000.0,69582,15827,20736,-4909,27722,35094,-7372,12281,26033,13752,37.41341151447213,-32.05870263051004,19.763731999655082,-0.7169210502428811
26,2020-10-05,789000.0,-17000.0,111800,29858,20876,8982,44298,70517,-26219,17237,37644,20407,33.67084078711986,-3.7425707273522733,18.253130590339893,-1.5106014093151892
27,2020-09-29,806000.0,7000.0,76019,16141,25466,-9325,38990,31070,7920,1405,20888,19483,27.477341191018034,-6.193499596101823,25.629119036030467,7.375988445690574
28,2020-09-28,799000.0,15000.0,76993,28550,22511,6039,36777,21155,15622,-21661,11666,33327,15.152026807631863,-12.325314383386171,43.285753250295485,17.65663421426502
29,2020-09-25,784000.0,-3000.0,67824,16937,16730,207,33873,32531,1342,-1549,17014,18563,25.08551545175749,9.933488644125628,27.36936777541873,-15.916385474876755
30,2020-09-24,787000.0,-18000.0,81161,25951,25997,-46,21168,30484,-9316,9362,34042,24680,41.943790736930296,16.858275285172805,30.40869383078079,3.0393260553620607
31,2020-09-23,805000.0,18000.0,107700,43370,36249,7121,40930,21428,19502,-26623,23400,50023,21.72701949860724,-20.216771238323055,46.44661095636026,16.03791712557947
32,2020-09-22,787000.0,-17000.0,101535,20557,34423,-13866,16678,39566,-22888,36754,64300,27546,63.32791648200128,41.60089698339404,27.129561235042104,-19.317049721318156
33,2020-09-21,804000.0,-17000.0,65547,28245,20492,7753,6192,22338,-16146,8393,31110,22717,47.46212641310815,-15.865790068893126,34.65757395456695,7.528012719524845
34,2020-09-18,821000.0,16000.0,83953,23187,14261,8926,44728,40393,4335,-13261,16038,29299,19.10354603170822,-28.358580381399932,34.899288887830096,0.24171493326314675
35,2020-09-17,805000.0,-17000.0,91497,18959,25101,-6142,11402,42825,-31423,37565,61136,23571,66.81749128386723,47.71394525215901,25.76150037706154,-9.137788510768555
36,2020-09-16,822000.0,-2000.0,91741,24234,18598,5636,27057,27342,-285,-5351,40450,45801,44.09151851407768,-22.72597276978955,49.924243250019074,24.162742872957534
37,2020-09-15,824000.0,-6000.0,70656,20635,15423,5212,18608,30535,-11927,6715,31413,24698,44.45906929347826,0.367550779400581,34.955276268115945,-14.96896698190313
38,2020-09-14,830000.0,12000.0,72282,27042,17148,9894,17856,20909,-3053,-6841,27384,34225,37.8849506101104,-6.574118683367857,47.34927091115353,12.393994643037587
39,2020-09-11,818000.0,-12000.0,99961,25237,20752,4485,21899,45150,-23251,18766,52825,34059,52.84560978781725,14.960659177706852,34.072288192395035,-13.276982718758497
40,2020-09-10,830000.0,39000.0,172103,69313,44565,24748,54693,26318,28375,-53123,48097,101220,27.946636607148044,-24.89897318066921,58.813617426773504,24.74132923437847
41,2020-09-09,791000.0,-20000.0,102424,20764,28899,-8135,10224,46288,-36064,44199,71436,27237,69.7453721783957,41.798735571247654,26.592400218698742,-32.22121720807476
42,2020-09-08,811000.0,-1000.0,54468,12667,16021,-3354,7506,15798,-8292,11646,34295,22649,62.96357494308585,-6.7817972353098455,41.58221340970845,14.98981319100971
43,2020-09-07,812000.0,-1000.0,69441,9624,25953,-16329,9969,24833,-14864,31193,49848,18655,71.7846805201538,8.821105577067947,26.86453248081105,-14.717680928897401
44,2020-09-04,813000.0,-22000.0,123738,16918,31892,-14974,11531,59020,-47489,62463,95289,32826,77.00867962953983,5.223999109386028,26.52863307957135,-0.3358994012397005
45,2020-09-03,835000.0,-15000.0,70056,13881,21941,-8060,12877,21768,-8891,16951,43298,26347,61.80484184081306,-15.203837788726766,37.60848464085874,11.079851561287391
46,2020-09-02,850000.0,22000.0,108559,29228,18538,10690,55996,32943,23053,-33743,23335,57078,21.49522379535552,-40.30961804545754,52.57786088670677,14.969376245848032
47,2020-09-01,828000.0,3000.0,98347,21282,25361,-4079,43871,50716,-6845,10924,33194,22270,33.75191922478571,12.256695429430188,22.644310451767723,-29.93355043493905
48,2020-08-31,825000.0,-31000.0,135345,34565,34312,253,29422,65565,-36143,35890,71358,35468,52.72304111714507,18.971121892359363,26.205622667996604,3.561312216228881
49,2020-08-28,856000.0,-7000.0,99519,42485,24195,18290,12244,39660,-27416,9126,44790,35664,45.0064811744491,-7.716559942695973,35.836372953908295,9.630750285911692
50,2020-08-27,863000.0,45000.0,232351,102988,29602,73386,65919,44268,21651,-95037,63444,158481,27.305240777960933,-17.701240396488167,68.20758249372716,32.371209539818864
51,2020-08-26,818000.0,-8000.0,93233,18131,23978,-5847,30275,28505,1770,4077,44827,40750,48.08061523280384,20.775374454842904,43.70770006328231,-24.49988243044485
52,2020-08-25,826000.0,-15000.0,101156,21871,29575,-7704,21569,29603,-8034,15738,57716,41978,57.056427695836135,8.975812463032298,41.498279884534774,-2.2094201787475356
53,2020-08-24,841000.0,18000.0,106150,26881,23149,3732,51796,38303,13493,-17225,27473,44698,25.881300047103156,-31.17512764873298,42.10833725859632,0.6100573740615474
54,2020-08-21,823000.0,40000.0,158623,33566,27058,6508,75945,41831,34114,-40622,49112,89734,30.96146208305227,5.080162035949115,56.570610819364155,14.462273560767834
55,2020-08-20,783000.0,-58000.0,271930,37960,63416,-25456,45363,139454,-94091,119547,188607,69060,69.35865847828485,38.397196395232584,25.396241679844078,-31.174369139520078
56,2020-08-19,841000.0,7000.0,175606,23594,30850,-7256,91912,103344,-11432,18688,60100,41412,34.224343131783655,-35.1343153465012,23.582337733334853,-1.8139039465092246
57,2020-08-18,834000.0,-38000.0,170816,60611,34524,26087,31524,77524,-46000,19913,78681,58768,46.06184432371675,11.837501191933093,34.40427126264519,10.821933529310336
58,2020-08-14,872000.0,-25000.0,133502,39300,25599,13701,30069,49356,-19287,5586,64133,58547,48.03898068942787,1.9771363657111252,43.85477371125526,9.450502448610074
59,2020-08-13,897000.0,47000.0,363276,129978,66365,63613,101585,36263,65322,-128935,131713,260648,36.25700569264141,-11.781974996786467,71.7493035598278,27.89452984857253
60,2020-08-12,850000.0,10000.0,94342,23698,24198,-500,20765,19207,1558,-1058,49879,50937,52.87040766572682,16.613401973085416,53.991859405142996,-17.757444154684798
61,2020-08-11,840000.0,-1000.0,113783,29926,30821,-895,32328,26621,5707,-4812,51529,56341,45.28708154996792,-7.583326115758901,49.51618431575894,-4.475675089384055
62,2020-08-10,841000.0,-24000.0,112532,30674,34675,-4001,12308,30015,-17707,21708,69550,47842,61.804642235097575,16.517560685129652,42.51412931432837,-7.00205500143057
63,2020-08-07,865000.0,11000.0,141611,31782,36497,-4715,26020,25553,467,4248,83809,79561,59.18254937822627,-2.622092856871305,56.1827824109709,13.66865309664253
64,2020-08-06,854000.0,8000.0,98102,22396,24714,-2318,35060,26563,8497,-6179,40646,46825,41.432386699557604,-17.750162678668666,47.73093311043608,-8.451849300534825
65,2020-08-05,846000.0,0.0,69372,14896,22402,-7506,13977,18568,-4591,12097,40499,28402,58.379461454189006,16.9470747546314,40.9415902669665,-6.789342843469576
66,2020-08-04,846000.0,2000.0,122293,17924,35991,-18067,44461,42998,1463,16604,59908,43304,48.98726828191311,-9.392193172275896,35.410039822393756,-5.531550444572744
67,2020-08-03,844000.0,33000.0,152000,45622,27581,18041,34552,36970,-2418,-15623,71826,87449,47.25394736842105,-1.733320913492058,57.53223684210526,22.122197019711507
68,2020-07-31,811000.0,-14000.0,101033,13479,25674,-12195,26725,35005,-8280,20475,60829,40354,60.207061059257875,12.953113690836823,39.94140528342225,-17.590831558683014
69,2020-07-30,825000.0,13000.0,137745,25825,27518,-1693,55286,55489,-203,1896,56634,54738,41.1151039965153,-19.091957062742573,39.738647500816725,-0.20275778260552357
70,2020-07-29,812000.0,18000.0,179741,46349,37393,8956,41655,62476,-20821,11865,91737,79872,51.0384386422686,9.9233346457533,44.43727363261582,4.698626131799095
71,2020-07-28,794000.0,9000.0,177440,31837,42782,-10945,57164,73673,-16509,27454,88439,60985,49.84163660955816,-1.196802032710444,34.3693642921551,-10.067909340460723
72,2020-07-27,785000.0,-17000.0,145319,20977,22841,-1864,51364,65293,-13929,15793,72978,57185,50.21917299183176,0.377536382273604,39.35135804677984,4.981993754624746
73,2020-07-24,802000.0,-9000.0,197544,30473,35677,-5204,45594,79148,-33554,38758,121477,82719,61.49364192281214,11.274468930980376,41.87370914834164,2.522351101561796
74,2020-07-23,811000.0,-50000.0,339183,39720,92132,-52412,50619,172949,-122330,174742,248844,74102,73.36570523876492,11.87206331595278,21.847203427058552,-20.026505721283087
75,2020-07-22,861000.0,2000.0,93362,21389,32908,-11519,28791,27088,1703,9816,43182,33366,46.25222253165099,-27.113482707113924,35.73830894796598,13.89110552090743
76,2020-07-21,859000.0,0.0,127020,22827,30732,-7905,56330,65723,-9393,17298,47863,30565,37.68146748543536,-8.57075504621563,24.06313966304519,-11.675169284920791
77,2020-07-20,859000.0,-21000.0,117063,16079,33388,-17309,53217,48005,5212,12097,47767,35670,40.80452405969435,3.123056574258989,30.47077214833039,6.407632485285198
78,2020-07-17,880000.0,1000.0,84865,14671,20161,-5490,29577,29093,484,5006,40617,35611,47.86071996700642,7.056195907312066,41.96193955105167,11.491167402721281
79,2020-07-16,879000.0,-49000.0,199187,24397,57300,-32903,42167,68897,-26730,59633,132623,72990,66.58215646603442,18.721436499028002,36.64395768800173,-5.317981863049944
80,2020-07-15,928000.0,-18000.0,110775,30594,38361,-7767,22589,38953,-16364,24131,57592,33461,51.99006996163394,-14.592086504400477,30.206273978785823,-6.437683709215904
81,2020-07-14,946000.0,-19000.0,91158,26872,33719,-6847,21489,32452,-10963,17810,42797,24987,46.94815594901161,-5.041914012622335,27.41064964128217,-2.7956243375036536
82,2020-07-13,965000.0,21000.0,117007,26270,22739,3531,45351,23462,21889,-25420,45386,70806,38.789132274137444,-8.159023674874163,60.514328202586164,33.103678561303994
83,2020-07-10,944000.0,-3000.0,128027,36194,45350,-9156,27331,32872,-5541,14697,64502,49805,50.38156013965804,11.592427865520598,38.90195036984386,-21.612377832742304
84,2020-07-09,947000.0,2000.0,130821,45852,38111,7741,32394,57662,-25268,17527,52575,35048,40.188501846033894,-10.193058293624148,26.79080575748542,-12.11114461235844
85,2020-07-08,945000.0,-17000.0,132370,32455,34458,-2003,23434,63268,-39834,41837,76481,34644,57.77819747676966,17.58969563073577,26.172093374631718,-0.6187123828537011
86,2020-07-07,962000.0,-33000.0,187793,33305,34868,-1563,42039,124897,-82858,84421,112449,28028,59.87922872524535,2.1010312484756852,14.924943954247496,-11.247149420384222
87,2020-07-06,995000.0,51000.0,138049,43444,31738,11706,39436,36146,3290,-14996,55169,70165,39.96334634803584,-19.915882377209506,50.82615593014075,35.901211975893254
88,2020-07-03,944000.0,-20000.0,81378,20951,18657,2294,15991,32909,-16918,14624,44436,29812,54.604438546044385,14.641092198008543,36.633979699673134,-14.192176230467616
89,2020-07-02,964000.0,71000.0,220292,40047,28420,11627,139359,107185,32174,-43801,40886,84687,18.559911390336463,-36.044527155707925,38.44306647540537,1.8090867757322329
90,2020-07-01,893000.0,2000.0,74232,23738,22025,1713,25407,37667,-12260,10547,25087,14540,33.79539821101412,15.235486820677654,19.58724000431081,-18.855826471094556
91,2020-06-30,891000.0,1000.0,97938,31862,26942,4920,25222,37596,-12374,7454,40854,33400,41.714145684004166,7.918747472990049,34.10320815209623,14.515968147785419
92,2020-06-29,890000.0,-19000.0,80756,23343,29053,-5710,21937,27121,-5184,10894,35476,24582,43.92986279657239,2.215717112568221,30.439843479122292,-3.6633646729739375
93,2020-06-26,909000.0,-3000.0,84137,14391,24190,-9799,32936,40790,-7854,17653,36810,19157,43.750074283608875,-0.17978851296351195,22.768817523800468,-7.671025955321824
94,2020-06-25,912000.0,-31000.0,88590,16550,40744,-24194,17289,30113,-12824,37018,54751,17733,61.80268653346879,18.052612249859912,20.016931933626818,-2.75188559017365
95,2020-06-24,943000.0,23000.0,91604,18594,24152,-5558,35137,33962,1175,4383,37873,33490,41.34426444260076,-20.458422090868027,36.559538884764855,16.542606951138037
96,2020-06-23,920000.0,32000.0,143448,38722,51102,-12380,41646,25355,16291,-3911,63080,66991,43.97412302715967,2.62985858455891,46.70054653951258,10.141007654747725
97,2020-06-22,888000.0,31000.0,113368,31134,27299,3835,45770,24350,21420,-25255,36464,61719,32.1642791616682,-11.809843865491473,54.44128854703267,7.74074200752009
98,2020-06-19,857000.0,25000.0,99988,26859,32525,-5666,48909,40391,8518,-2852,24220,27072,24.22290674880986,-7.941372412858339,27.075249029883587,-27.366039517149083
99,2020-06-18,832000.0,-34000.0,115343,22763,27382,-4619,29701,69688,-39987,44606,62879,18273,54.514795002730985,30.291888253921126,15.842313794508552,-11.232935235375034
100,2020-06-17,866000.0,-9000.0,113585,29694,35175,-5481,40256,50025,-9769,15250,43635,28385,38.41616410617599,-16.098630896554994,24.990095523176475,9.147781728667923
101,2020-06-16,875000.0,65000.0,149986,51906,44815,7091,63392,42440,20952,-28043,34688,62731,23.12749189924393,-15.288672206932063,41.82457029322737,16.834474770050893
102,2020-06-15,810000.0,-14000.0,152388,55915,49779,6136,39711,45220,-5509,-627,56762,57389,37.2483397642859,14.120847865041974,37.659789484736336,-4.164780808491031
103,2020-06-12,824000.0,-1000.0,107916,42363,30984,11379,36280,40891,-4611,-6768,29273,36041,27.125727417621114,-10.122612346664788,33.39727195225917,-4.262517532477169
104,2020-06-11,825000.0,3000.0,131861,56348,56373,-25,41322,43951,-2629,2654,34191,31537,25.929577357975443,-1.196150059645671,23.916851836403485,-9.480420115855683
105,2020-06-10,822000.0,22000.0,127949,40581,28608,11973,51039,25947,25092,-37065,36329,73394,28.393344223088885,2.463766865113442,57.361917639059314,33.44506580265583
106,2020-06-09,800000.0,3000.0,78631,27771,30208,-2437,32321,28804,3517,-1080,18539,19619,23.57721509328382,-4.816129129805066,24.95071918200201,-32.4111984570573
107,2020-06-08,797000.0,-8000.0,71804,19999,30106,-10107,27105,26680,425,9682,24700,15018,34.39919781627764,10.821982722993823,20.91526934432622,-4.035449837675792
108,2020-06-05,805000.0,5000.0,70207,28094,28881,-787,23369,12667,10702,-9915,18744,28659,26.69819248792855,-7.7010053283490905,40.8207158830316,19.905446538705384
109,2020-06-04,800000.0,8000.0,104491,43476,45730,-2254,34747,27273,7474,-5220,26268,31488,25.139007187221868,-1.5591853007066838,30.13465274521251,-10.686063137819094
110,2020-06-03,792000.0,-18000.0,120560,45307,63362,-18055,19210,28486,-9276,27331,56043,28712,46.48556735235567,21.346560165133805,23.815527538155276,-6.319125207057233
111,2020-06-02,810000.0,-6000.0,67525,22605,33191,-10586,15341,20873,-5532,16118,29579,13461,43.80451684561273,-2.6810505067429418,19.93483894853758,-3.880688589617698
112,2020-06-01,816000.0,26000.0,84776,26186,23584,2602,35080,12650,22430,-25032,23510,48542,27.731905256204588,-16.072611589408144,57.25912994243654,37.324290993898956
113,2020-05-29,790000.0,-2000.0,106253,20744,32785,-12041,61181,46484,14697,-2656,24328,26984,22.896294692855733,-4.835610563348855,25.395988819139227,-31.86314112329731
114,2020-05-28,792000.0,5000.0,111114,37068,39442,-2374,34468,33809,659,1715,39578,37863,35.61927389887863,12.722979206022899,34.07581402883525,8.67982520969602
115,2020-05-27,787000.0,-14000.0,93977,20397,36444,-16047,27148,26678,470,15577,46432,30855,49.40783383168222,13.788559932803587,32.83250156953297,-1.243312459302274
116,2020-05-26,801000.0,-11000.0,114011,34410,39398,-4988,15028,35179,-20151,25139,64573,39434,56.63751743252844,7.229683600846222,34.58789064213102,1.7553890725980494
117,2020-05-25,812000.0,22000.0,103070,36585,25946,10639,11085,17146,-6061,-4578,55400,59978,53.74987872319783,-2.8876387093306093,58.191520325992045,23.603629683861023
118,2020-05-22,790000.0,-2000.0,93494,27685,35651,-7966,30696,24178,6518,1448,35113,33665,37.55642073288126,-16.193457990316574,36.0076582454489,-22.183862080543143
119,2020-05-21,792000.0,42000.0,208754,43352,56938,-13586,99594,53726,45868,-32282,65808,98090,31.52418636289604,-6.032234369985218,46.988321181869566,10.980662936420664
120,2020-05-20,750000.0,18000.0,89022,22064,19562,2502,46193,28923,17270,-19772,20765,40537,23.325694772078812,-8.198491590817227,45.5359349374312,-1.4523862444383653
121,2020-05-19,732000.0,5000.0,111353,29848,43861,-14013,54946,29105,25841,-11828,26559,38387,23.85117598987005,0.5254812177912385,34.47325173098165,-11.062683206449549
122,2020-05-18,727000.0,-18000.0,110727,27939,31965,-4026,29312,46246,-16934,20960,53476,32516,48.2953570493195,24.44418105944945,29.365917978451506,-5.107333752530145
123,2020-05-15,745000.0,-8000.0,100195,31914,39392,-7478,26945,28634,-1689,9167,41336,32169,41.25555167423524,-7.039805375084256,32.106392534557614,2.7404745561061077
124,2020-05-14,753000.0,32000.0,214951,56532,54739,1793,81449,54570,26879,-28672,76970,105642,35.80816092970026,-5.447390744534985,49.14701490107048,17.040622366512864
125,2020-05-13,721000.0,-26000.0,175101,52532,56102,-3570,25009,61820,-36811,40381,97560,57179,55.71641509757226,19.908254167872002,32.654867762034485,-16.492147139035993
126,2020-05-12,747000.0,48000.0,344771,73682,73432,250,147177,56692,90485,-90735,123912,214647,35.94037781599961,-19.77603728157265,62.25784651261272,29.602978750578238
127,2020-05-11,699000.0,20000.0,131682,32796,45722,-12926,36198,22865,13333,-407,62688,63095,47.60559529776279,11.665217481763179,47.914673227927885,-14.343173284684838
128,2020-05-08,679000.0,33000.0,194176,39406,36781,2625,98097,29875,68222,-70847,56673,127520,29.186408206987473,-18.419187090775317,65.67237969676995,17.757706468842066
129,2020-05-07,646000.0,5000.0,86250,27392,21590,5802,33489,24928,8561,-14363,25369,39732,29.413333333333334,0.22692512634586137,46.06608695652174,-19.606292740248215
130,2020-05-06,641000.0,17000.0,79496,29692,26275,3417,28812,20718,8094,-11511,20992,32503,26.406360068431116,-3.006973264902218,40.88633390359263,-5.179753052929108
131,2020-05-04,624000.0,-19000.0,127354,17757,59787,-42030,46918,45728,1190,40840,62679,21839,49.21635755453303,22.809997486101917,17.148263894341756,-23.738070009250873
132,2020-04-29,643000.0,-5000.0,89309,27716,30050,-2334,38279,27631,10648,-8314,23314,31628,26.104871849421674,-23.11148570511136,35.41412399646172,18.265860102119962
133,2020-04-28,648000.0,18000.0,100854,26564,26924,-360,38049,14444,23605,-23245,36241,59486,35.93412259305531,9.829250743633633,58.982291232871276,23.568167236409558
134,2020-04-27,630000.0,-23000.0,216386,41756,76645,-34889,25830,94891,-69061,103950,148800,44850,68.76600149732423,32.83187890426892,20.72684924163301,-38.25544199123827
135,2020-04-24,653000.0,-8000.0,98673,21601,21663,-62,28910,32035,-3125,3187,48162,44975,48.809704782463285,-19.95629671486094,45.57984453700607,24.85299529537306
136,2020-04-23,661000.0,-16000.0,104028,25872,22796,3076,20707,45173,-24466,21390,57449,36059,55.224554927519506,6.414850145056221,34.66278309685854,-10.917061440147528
137,2020-04-22,677000.0,35000.0,139859,24763,29786,-5023,77689,26280,51409,-46386,37407,83793,26.7462229817173,-28.478331945802207,59.912483286738784,25.249700189880244
138,2020-04-21,642000.0,0.0,124368,24857,29140,-4283,50035,50006,29,4254,49476,45222,39.78193747587804,13.03571449416074,36.36144345812428,-23.551039828614506
139,2020-04-20,642000.0,-7000.0,116669,15733,37832,-22099,52203,45025,7178,14921,48733,33812,41.77030745099384,1.988369975115802,28.981134663021024,-7.380308795103254
140,2020-04-17,649000.0,-6000.0,143976,22223,44331,-22108,47889,65382,-17493,39601,73864,34263,51.30299494360171,9.53268749260787,23.797716286047674,-5.18341837697335
141,2020-04-16,655000.0,-1000.0,112493,31318,30786,532,53813,64136,-10323,9791,27362,17571,24.32329122700968,-26.97970371659203,15.619638555287885,-8.178077730759789
142,2020-04-14,656000.0,5000.0,80586,23169,20947,2222,39962,42064,-2102,-120,17455,17575,21.66008984190802,-2.663201385101658,21.808999081726355,6.18936052643847
143,2020-04-13,651000.0,1000.0,50919,21919,23958,-2039,6487,8419,-1932,3971,22513,18542,44.21335847129755,22.55326862938953,36.414697853453525,14.60569877172717
144,2020-04-10,650000.0,-5000.0,87704,24628,33436,-8808,26730,33308,-6578,15386,36346,20960,41.441667426799235,-2.7716910444983185,23.898567910243546,-12.516129943209979
145,2020-04-09,655000.0,-8000.0,163906,27862,78471,-50609,81459,63783,17676,32933,54585,21652,33.302624675118665,-8.13904275168057,13.210010615840787,-10.68855729440276
146,2020-04-08,663000.0,-12000.0,106457,31285,56580,-25295,33129,31237,1892,23403,42043,18640,39.492940811783164,6.190316136664499,17.509416947687797,4.29940633184701
147,2020-04-07,675000.0,-3000.0,99068,27283,43381,-16098,34883,26177,8706,7392,36902,29510,37.249162191625956,-2.243778620157208,29.78762062421771,12.278203676529913
148,2020-04-06,678000.0,31000.0,97158,39390,21407,17983,41285,28526,12759,-30742,16483,47225,16.965149550217173,-20.284012641408783,48.606393709215915,18.818773084998206
149,2020-04-03,647000.0,-9000.0,99891,37136,28078,9058,29414,44391,-14977,5919,33341,27422,33.37738134566678,16.412231795449603,27.451922595629235,-21.15447111358668
150,2020-04-02,656000.0,38000.0,148473,46317,34861,11456,65468,60335,5133,-16589,36688,53277,24.710216672391613,-8.667164673275163,35.883291911660706,8.431369316031471
151,2020-04-01,618000.0,-34000.0,123474,31748,46103,-14355,28747,37559,-8812,23167,62979,39812,51.00587978035862,26.295663107967005,32.243225294393966,-3.64006661726674
152,2020-03-31,652000.0,28000.0,193212,55584,45811,9773,95761,81093,14668,-24441,41867,66308,21.668943957932218,-29.3369358224264,34.31877937188166,2.075554077487695
153,2020-03-30,624000.0,2000.0,95800,52650,33606,19044,20819,40946,-20127,1083,22331,21248,23.310020876826723,1.6410769188945054,22.17954070981211,-12.139238662069552
154,2020-03-27,622000.0,-3000.0,167169,54733,47521,7212,75316,80574,-5258,-1954,37120,39074,22.205073907243566,-1.1049469695831569,23.373950911951376,1.1944102021392666
155,2020-03-26,625000.0,-26000.0,171361,44622,55686,-11064,67796,87078,-19282,30346,58943,28597,34.39697480756998,12.191900900326416,16.68816125022613,-6.685789661725245
156,2020-03-25,651000.0,2000.0,183766,49017,69665,-20648,73064,69828,3236,17412,61685,44273,33.56714517375357,-0.8298296338164093,24.09205184854652,7.403890598320391
157,2020-03-24,649000.0,77000.0,236136,83083,50391,32692,109734,107837,1897,-34589,43319,77908,18.344936816072092,-15.222208357681481,32.992851577057294,8.900799728510773
158,2020-03-23,572000.0,5000.0,175741,57146,51117,6029,75100,71004,4096,-10125,43495,53620,24.74948930528448,6.404552489212389,30.510808519355187,-2.482043057702107
159,2020-03-20,567000.0,37000.0,236382,91663,43586,48077,96678,138376,-41698,-6379,48041,54420,20.323459485070774,-4.4260298202137065,23.022057517069825,-7.488751002285362
160,2020-03-19,530000.0,-40000.0,400206,139869,64276,75593,154192,223095,-68903,-6690,106145,112835,26.52259086570416,6.199131380633386,28.194229971564646,5.17217245449482
161,2020-03-18,570000.0,-7000.0,211341,73658,35829,37829,82073,118364,-36291,-1538,55610,57148,26.3129255563284,-0.20966530937576167,27.040659408254907,-1.1535705633097386
162,2020-03-17,577000.0,-18000.0,271203,64196,32368,31828,144115,195779,-51664,19836,62892,43056,23.190008960077876,-3.1229165962505228,15.875930575989203,-11.164728832265704
163,2020-03-16,595000.0,-46000.0,201806,51109,43211,7898,84410,125351,-40941,33043,66287,33244,32.84689256018156,9.656883600103683,16.473246583352328,0.5973160073631245
164,2020-03-13,641000.0,0.0,229329,102603,50624,51979,87862,136050,-48188,-3791,38864,42655,16.946831844206358,-15.9000607159752,18.5999154053783,2.126668822025973
165,2020-03-12,641000.0,-25000.0,178886,77281,52507,24774,74635,98692,-24057,-717,26970,27687,15.076640989233367,-1.870190854972991,15.477454915420994,-3.122460489957307
166,2020-03-11,666000.0,-10000.0,112122,39839,45839,-6000,46616,49131,-2515,8515,25667,17152,22.892028326287438,7.815387337054071,15.297622232924848,-0.17983268249614603
167,2020-03-10,676000.0,-4000.0,117053,58565,44659,13906,29018,51296,-22278,8372,29470,21098,25.176629390105337,2.284601063817899,18.0243137723937,2.7266915394688525
168,2020-03-09,680000.0,-20000.0,93380,43281,27914,15367,26564,46369,-19805,4438,23535,19097,25.203469693724568,0.026840303619231065,20.450846005568643,2.4265322331749424
169,2020-03-06,700000.0,-11000.0,94325,29488,29327,161,47908,52354,-4446,4285,16929,12644,17.94752186588921,-7.255947827835357,13.404717731248345,-7.0461282743202975
170,2020-03-05,711000.0,-9000.0,115007,36232,50549,-14317,48281,50899,-2618,16935,30494,13559,26.514907788221585,8.567385922332374,11.789717147651881,-1.6150005835964638
171,2020-03-04,720000.0,41000.0,156369,37538,46994,-9456,87300,53891,33409,-23953,31531,55484,20.16448272995287,-6.350425058268716,35.48273634799737,23.693019200345486
172,2020-03-03,679000.0,18000.0,111858,32809,45845,-13036,58746,43204,15542,-2506,20303,22809,18.150691054730103,-2.013791675222766,20.391031486348762,-15.091704861648605
173,2020-03-02,661000.0,12000.0,75909,28555,31240,-2685,37868,27802,10066,-7381,9486,16867,12.496541912026242,-5.6541491427038615,22.22002661081031,1.8289951244615494
174,2020-02-28,649000.0,-5000.0,122145,39718,47212,-7494,63371,52538,10833,-3339,19056,22395,15.60112980474027,3.1045878927140276,18.334766056735845,-3.885260554074467
175,2020-02-27,654000.0,-18000.0,68808,24290,35102,-10812,21252,22344,-1092,11904,23266,11362,33.81292872921753,18.211798924477264,16.512614812231135,-1.8221512445047097
176,2020-02-26,672000.0,3000.0,89770,33803,33585,218,45423,45147,276,-494,10544,11038,11.745572017377743,-22.06735671183979,12.295867216219227,-4.216747596011908
177,2020-02-25,669000.0,6000.0,92439,35949,43051,-7102,42078,32744,9334,-2232,14412,16644,15.590822055625871,3.8452500382481283,18.00538733651381,5.709520120294583
178,2020-02-24,663000.0,-6000.0,96037,30528,34876,-4348,48003,42451,5552,-1204,17506,18710,18.22839114091444,2.6375690852885683,19.48207461707467,1.47668728056086
179,2020-02-21,669000.0,-7000.0,79837,25752,25495,257,35301,37547,-2246,1989,18784,16795,23.527938174029586,5.299547033115147,21.036612097147938,1.554537480073268
180,2020-02-20,676000.0,-11000.0,110032,33241,39044,-5803,47753,51809,-4056,9859,29038,19179,26.390504580485675,2.8625664064560894,17.430383888323398,-3.6062282088245396
181,2020-02-19,687000.0,32000.0,140128,31814,26303,5511,87193,60054,27139,-32650,21121,53771,15.072647864809316,-11.31785671567636,38.37277346426124,20.942389575937845
182,2020-02-18,655000.0,-3000.0,52270,14327,23197,-8870,24977,18124,6853,2017,12966,10949,24.805815955615078,9.733168090805762,20.94700593074421,-17.425767533517032
183,2020-02-17,658000.0,1000.0,44676,15214,13593,1621,19334,18700,634,-2255,10128,12383,22.66988987375772,-2.135926081857356,27.717342644820487,6.770336714076276
184,2020-02-14,657000.0,28000.0,157977,36327,31735,4592,101302,59731,41571,-46163,20348,66511,12.880356001190046,-9.789533872567675,42.10169834849376,14.384355703673275
185,2020-02-13,629000.0,-21000.0,156229,33712,52513,-18801,63511,78745,-15234,34035,59006,24971,37.76891614232953,24.888560141139486,15.983588194253306,-26.118110154240455
186,2020-02-12,650000.0,6000.0,172621,49038,56607,-7569,95578,84099,11479,-3910,28005,31915,16.22340271461757,-21.54551342771196,18.488480544082122,2.5048923498288165
187,2020-02-11,644000.0,-4000.0,120028,30172,48000,-17828,58970,50438,8532,9296,30886,21590,25.732329123204583,9.508926408587012,17.9874695904289,-0.5010109536532212
188,2020-02-10,648000.0,-24000.0,120937,35863,58109,-22246,36937,49644,-12707,34953,48137,13184,39.80336869609797,14.071039572893387,10.901543778992368,-7.0859258114365336
189,2020-02-07,672000.0,2000.0,58755,19467,29162,-9695,32797,25475,7322,2373,6491,4118,11.047570419538763,-28.755798276559204,7.008765211471364,-3.8927785675210034
190,2020-02-06,670000.0,13000.0,79693,27132,28095,-963,42698,33081,9617,-8654,9863,18517,12.376243835719574,1.328673416180811,23.235415908549058,16.226650697077694
191,2020-02-05,657000.0,1000.0,69095,19704,45094,-25390,38566,14051,24515,875,10825,9950,15.666835516318113,3.2905916805985385,14.400463130472538,-8.83495277807652
192,2020-02-04,656000.0,16000.0,71409,18951,35300,-16349,40920,24313,16607,-258,11538,11796,16.157627189850018,0.49079167353190556,16.5189261857749,2.118463055302364
193,2020-02-03,640000.0,4000.0,94982,28140,43556,-15416,54564,39765,14799,617,12278,11661,12.926659788170392,-3.230967401679626,12.277063022467415,-4.241863163307487
194,2020-01-31,636000.0,-19000.0,107016,30995,47678,-16683,52509,39898,12611,4072,23512,19440,21.97054646034238,9.043886672171988,18.16550796142633,5.888444938958914
195,2020-01-30,655000.0,6000.0,77424,17640,32861,-15221,42143,30898,11245,3976,17641,13665,22.784924571192395,0.814378110850015,17.64956602603844,-0.5159419353878896
196,2020-01-29,649000.0,5000.0,80218,17693,38978,-21285,46931,31584,15347,5938,15594,9656,19.439527288139818,-3.345397283052577,12.037198633723104,-5.612367392315335
197,2020-01-28,644000.0,-2000.0,90471,35873,35597,276,44350,33977,10373,-10649,10248,20897,11.327386676393541,-8.112140611746277,23.09800930684971,11.060810673126607
198,2020-01-23,646000.0,3000.0,51057,19773,31062,-11289,23697,7919,15778,-4489,7587,12076,14.859862506610257,3.5324758302167165,23.651996787903716,0.5539874810540049
199,2020-01-22,643000.0,11000.0,56758,20473,21779,-1306,24387,23774,613,693,11898,11205,20.96268367454808,6.102821167937824,19.741710419676522,-3.9102863682271938
200,2020-01-21,632000.0,2000.0,59896,24414,27226,-2812,13621,19256,-5635,8447,21861,13414,36.498263657005474,15.535579982457392,22.39548550821424,2.653775088537717
201,2020-01-20,630000.0,-1000.0,40779,20312,21669,-1357,11357,11133,224,1133,9110,7977,22.33992986586233,-14.158333791143143,19.561539027440595,-2.833946480773644
202,2020-01-17,631000.0,-1000.0,49319,17579,24367,-6788,20423,15293,5130,1658,11317,9659,22.946531762606703,0.6066018967443725,19.584744216224983,0.023205188784388042
203,2020-01-16,632000.0,13000.0,79907,23753,25336,-1583,45277,33354,11923,-10340,10877,21217,13.612074036066929,-9.334457726539775,26.552116835821643,6.967372619596659
204,2020-01-15,619000.0,9000.0,56839,14038,24713,-10675,35863,17705,18158,-7483,6938,14421,12.206407572265523,-1.4056664638014063,25.371663822375485,-1.180453013446158
205,2020-01-14,610000.0,-4000.0,64120,20176,27286,-7110,33589,24593,8996,-1886,10355,12241,16.149407361197753,3.94299978893223,19.09076731129133,-6.280896511084155
206,2020-01-13,614000.0,6000.0,66084,13349,35227,-21878,43507,17307,26200,-4322,9228,13550,13.964045759941893,-2.1853616012558597,20.504206767144844,1.4134394558535135
207,2020-01-10,608000.0,0.0,53031,14261,26721,-12460,28159,12629,15530,-3070,10611,13681,20.00905130961136,6.045005549669465,25.798118081876638,5.293911314731794
208,2020-01-09,608000.0,4000.0,71171,27246,26140,1106,32841,31226,1615,-2721,11084,13805,15.573758974863358,-4.435292334748,19.39694538505852,-6.401172696818119
209,2020-01-08,604000.0,10000.0,109267,39111,37899,1212,55323,33101,22222,-23434,14833,38267,13.575004347149644,-1.9987546277137138,35.0215527103334,15.624607325274884
210,2020-01-07,594000.0,15000.0,84378,35709,24001,11708,39322,25375,13947,-25655,9347,35002,11.077532058119415,-2.497472289030229,41.482376922894595,6.460824212561192
211,2020-01-06,579000.0,14000.0,107006,23590,37682,-14092,67988,25232,42756,-28664,15428,44092,14.417883109358353,3.3403510512389385,41.20516606545427,-0.27721085744032337
212,2020-01-03,565000.0,24000.0,112404,31330,34662,-3332,61318,23790,37528,-34196,19756,53952,17.575886979111065,3.1580038697527115,47.99829187573396,6.79312581027969
213,2020-01-02,541000.0,0.0,40246,16614,23978,-7364,16252,10133,6119,1245,7380,6135,18.337226059732643,0.7613390806215783,15.243750931769618,-32.754540943964344
214,2019-12-30,541000.0,0.0,36232,14094,12076,2018,15346,15993,-647,-1371,6792,8163,18.74586001324796,0.4086339535153165,22.529807904614703,7.286056972845085
215,2019-12-27,541000.0,4000.0,50220,11263,18087,-6824,17678,14665,3013,3811,21279,17468,42.371565113500594,23.625705100252635,34.78295499800876,12.253147093394059
216,2019-12-26,537000.0,4000.0,43562,14093,5406,8687,9062,5717,3345,-12032,20407,32439,46.845874845048435,4.474309731547841,74.46627794867085,39.68332295066209
217,2019-12-24,533000.0,-7000.0,33551,12880,14909,-2029,10878,7909,2969,-940,9793,10733,29.188399749634886,-17.65747509541355,31.990104616851955,-42.4761733318189
218,2019-12-23,540000.0,1000.0,43978,15875,7331,8544,24778,10269,14509,-23053,3325,26378,7.560598481058712,-21.627801268576174,59.979989994997496,27.98988537814554
219,2019-12-20,539000.0,6000.0,65798,7183,10882,-3699,53470,30180,23290,-19591,5145,24736,7.819386607495668,0.25878812643695603,37.59384783732028,-22.386142157677213
220,2019-12-19,533000.0,-8000.0,63932,14156,27471,-13315,34998,23005,11993,1322,14778,13456,23.115184883939186,15.295798276443518,21.04736282299944,-16.546485014320844
221,2019-12-18,541000.0,2000.0,37838,13584,17419,-3835,19659,9668,9991,-6156,4595,10751,12.14387652624346,-10.971308357695726,28.413235371848405,7.365872548848966
222,2019-12-17,539000.0,-3000.0,68773,23009,19290,3719,37091,33262,3829,-7548,8673,16221,12.611053756561441,0.4671772303179811,23.58629113169412,-4.826944240154283
223,2019-12-16,542000.0,4000.0,59733,17189,16952,237,34207,22556,11651,-11888,8337,20225,13.957109135653658,1.346055379092217,33.85900590963119,10.272714777937072
224,2019-12-13,538000.0,2000.0,81844,25799,31508,-5709,40851,32503,8348,-2639,15194,17833,18.56458628610527,4.607477150451613,21.789013244709444,-12.069992664921749
225,2019-12-12,536000.0,-9000.0,152110,60972,73667,-12695,70245,57924,12321,374,20893,20519,13.735454605219907,-4.829131680885364,13.48957990927618,-8.299433335433264
226,2019-12-11,545000.0,5000.0,77125,23513,31515,-8002,43331,22821,20510,-12508,10281,22789,13.33030794165316,-0.40514666356674667,29.54813614262561,16.058556233349428
227,2019-12-10,540000.0,0.0,66681,14274,25678,-11404,41955,27584,14371,-2967,10452,13419,15.674629954559768,2.3443220129066074,20.124173302739912,-9.423962839885696
228,2019-12-09,540000.0,1000.0,68853,18654,17857,797,36482,26356,10126,-10923,13717,24640,19.92215299260744,4.247523038047673,35.78638548792355,15.662212185183641
229,2019-12-06,539000.0,37000.0,199337,63579,38628,24951,105346,46610,58736,-83687,30412,114099,15.256575547941425,-4.665577444666015,57.23924810747628,21.452862619552725
230,2019-12-05,502000.0,2000.0,118540,22392,23028,-636,75978,63755,12223,-11587,20170,31757,17.01535346718407,1.758777919242645,26.79011304201114,-30.44913506546514
231,2019-12-04,500000.0,15000.0,153060,69630,23902,45728,52101,66713,-14612,-31116,31329,62445,20.46844374754998,3.4530902803659096,40.79772638181105,14.007613339799914
232,2019-12-03,485000.0,-2000.0,109541,31056,34579,-3523,41262,47761,-6499,10022,37223,27201,33.98088386996649,13.51244012241651,24.831798139509406,-15.965928242301647
233,2019-12-02,487000.0,-6000.0,176172,51083,69405,-18322,57594,54092,3502,14820,67495,52675,38.311990554685195,4.331106684718705,29.89975705560475,5.067958916095343
234,2019-11-29,493000.0,-6000.0,168117,31577,43751,-12174,82089,86490,-4401,16575,54451,37876,32.38875307077809,-5.9232374839071085,22.529547874396997,-7.370209181207752
235,2019-11-28,499000.0,-6000.0,170595,52654,89611,-36957,59680,32915,26765,10192,58261,48069,34.15164571060113,1.7628926398230433,28.177261936164598,5.647714061767601
236,2019-11-27,505000.0,-16000.0,305519,87304,139068,-51764,91207,81433,9774,41990,127008,85018,41.57122797600149,7.419582265400358,27.827401896445064,-0.34986003971953394
237,2019-11-26,521000.0,-14000.0,188666,52905,47456,5449,69701,119787,-50086,44637,66060,21423,35.01425800091166,-6.556969975089828,11.35498712009583,-16.472414776349233
238,2019-11-25,535000.0,2000.0,69441,25767,35827,-10060,21686,24529,-2843,12903,21988,9085,31.66429054881122,-3.34996745210044,13.083048919226394,1.7280617991305647
239,2019-11-22,533000.0,-8000.0,58118,20093,16679,3414,21949,32174,-10225,6811,16076,9265,27.660965621666268,-4.003324927144952,15.941704807460683,2.8586558882342885
240,2019-11-21,541000.0,-15000.0,112569,42186,33715,8471,51600,70223,-18623,10152,18783,8631,16.685766063481065,-10.975199558185203,7.6672973909335616,-8.274407416527122
241,2019-11-20,556000.0,-5000.0,53708,31461,24487,6974,12927,20980,-8053,1079,9320,8241,17.353094511059805,0.6673284475787398,15.344082818202128,7.676785427268567
242,2019-11-19,561000.0,8000.0,80813,40308,41963,-1655,30605,16796,13809,-12154,9900,22054,12.250504250553748,-5.102590260506057,27.290163711284077,11.946080893081948
243,2019-11-18,553000.0,4000.0,83408,32342,26963,5379,40377,38044,2333,-7712,10689,18401,12.815317475541915,0.5648132249881677,22.06143295607136,-5.228730755212716
244,2019-11-15,549000.0,23000.0,90461,44675,31779,12896,30325,11284,19041,-31937,15461,47398,17.091343230784535,4.276025755242619,52.39606018063032,30.33462722455896
245,2019-11-14,526000.0,3000.0,57581,29826,34682,-4856,17452,13767,3685,1171,10303,9132,17.89305500078151,0.8017117699969738,15.859398065334052,-36.53666211529627
246,2019-11-13,523000.0,-11000.0,86729,21853,30892,-9039,20930,43293,-22363,31402,43946,12544,50.670479309112295,32.77742430833079,14.46344360017987,-1.3959544651541815
247,2019-11-12,534000.0,12000.0,48897,16358,16417,-59,20405,22576,-2171,2230,12134,9904,24.81542834938749,-25.855050959724807,20.254821359183588,5.791377759003717
248,2019-11-11,522000.0,-7000.0,54526,16073,22574,-6501,23256,25672,-2416,8917,15197,6280,27.871107361625647,3.0556790122381585,11.51744122070205,-8.737380138481537
249,합계,,,28815320,8187031,8461491,-274460,10658480,10956913,-298433,572893,9969809,9396916,34.59898762186226,6.72788026023661,32.61083340389765,21.0933921831956
