,날짜,종가,대비,거래량,기관 매수,기관 매도,기관 순매수,외국인 매수,외국인 매도,외국인 순매수,개인 순매수,개인 매수,개인 매도,개인매수비율(%),개인매수비율증가(%p),개인매도비율(%),개인매도비율증가(%p)
0,2020-11-11,243000.0,2000.0,423677,165285,192624,-27339,129386,49716,79670,-52331,129006,181337,30.449139320756142,,42.80076567762706,
1,2020-11-10,241000.0,8500.0,544843,176050,177875,-1825,209926,57900,152026,-150201,158867,309068,29.158307989641052,-1.2908313311150899,56.72606604104301,13.92530036341595
2,2020-11-09,232500.0,3000.0,332444,132205,121728,10477,56352,66225,-9873,-604,143887,144491,43.28157524274765,14.123267253106597,43.46325997762029,-13.262806063422723
3,2020-11-06,229500.0,-3500.0,428049,94278,147983,-53705,138394,130887,7507,46198,195377,149179,45.643606222652075,2.362030979904425,34.85091660066955,-8.61234337695074
4,2020-11-05,233000.0,6500.0,381030,110367,144883,-34516,97291,26259,71032,-36516,173372,209888,45.50087919586384,-0.14272702678823634,55.08437655827625,20.233459957606698
5,2020-11-04,226500.0,500.0,481871,179001,242654,-63653,58481,33439,25042,38611,244389,205778,50.71668558597633,5.2158063901124905,42.70396018851518,-12.380416369761065
6,2020-11-03,226000.0,-500.0,453788,86006,232004,-145998,46538,101060,-54522,200520,321244,120724,70.79164720089557,20.07496161491924,26.603612259469177,-16.100347929046006
7,2020-11-02,226500.0,1000.0,428586,142514,199101,-56587,35603,89447,-53844,110431,250469,140038,58.44077968015754,-12.350867520738028,32.67442240297163,6.070810143502452
8,2020-10-30,225500.0,-12500.0,888786,185620,334822,-149202,111678,333835,-222157,371359,591488,220129,66.55010317444244,8.1093234942849,24.76737932415677,-7.9070430788148585
9,2020-10-29,238000.0,-14500.0,696270,206537,237501,-30964,58010,224077,-166067,197031,431723,234692,62.00511295905324,-4.544990215389198,33.707038936044924,8.939659611888153
10,2020-10-28,252500.0,8000.0,487858,260703,184389,76314,38871,95656,-56785,-19529,188284,207813,38.59401711153655,-23.41109584751669,42.59702618384858,8.889987247803653
11,2020-10-27,244500.0,1000.0,796662,402009,286772,115237,173303,196108,-22805,-92432,221350,313782,27.78468158390886,-10.809335527627692,39.38709264405733,-3.209933539791244
12,2020-10-26,243500.0,9000.0,788372,394565,232375,162190,133866,72343,61523,-223713,259941,483654,32.97187114712344,5.187189563214577,61.34844971663124,21.961357072573904
13,2020-10-23,234500.0,500.0,372397,208769,144361,64408,54120,92295,-38175,-26233,109508,135741,29.40625193006388,-3.565619217059556,36.45061587499362,-24.897833841637613
14,2020-10-22,234000.0,2500.0,372056,172211,127664,44547,79682,103825,-24143,-20404,120163,140567,32.29701980347045,2.890767873406567,37.78114047347711,1.3305245984834855
15,2020-10-21,231500.0,-6000.0,476527,222231,207337,14894,82852,151191,-68339,53445,171444,117999,35.97781447850804,3.680794675037589,24.762290489311205,-13.018849984165904
16,2020-10-20,237500.0,15000.0,1301084,649469,295261,354208,313757,426032,-112275,-241933,337858,579791,25.967424086377207,-10.01039039213083,44.56214971516059,19.79985922584938
17,2020-10-19,222500.0,-6500.0,524241,194556,205855,-11299,81775,203463,-121688,132987,247910,114923,47.289319225318124,21.321895138940917,21.921787880001755,-22.64036183515883
18,2020-10-16,229000.0,-5500.0,446765,240685,146254,94431,55734,172073,-116339,21908,150346,128438,33.65214374447417,-13.637175480843958,28.748447170212525,6.82665929021077
19,2020-10-15,234500.0,3000.0,602103,297216,187790,109426,102672,136232,-33560,-75866,202215,278081,33.58478532742737,-0.06735841704679757,46.18495506582761,17.436507895615083
20,2020-10-14,231500.0,-4000.0,402918,93489,135534,-42045,144367,127363,17004,25041,165062,140021,40.96664830064678,7.3818629732194125,34.751736085258045,-11.433218980569563
21,2020-10-13,235500.0,8500.0,433346,226281,138889,87392,70334,59287,11047,-98439,136731,235170,31.552385391811622,-9.414262908835159,54.268413692522834,19.51667760726479
22,2020-10-12,227000.0,-2000.0,343564,107421,116728,-9307,90787,154639,-63852,73159,145356,72197,42.30827444086109,10.755889049049468,21.01413419333807,-33.25427949918476
23,2020-10-08,229000.0,-6000.0,499234,107245,298259,-191014,79118,102231,-23113,214127,312871,98744,62.67021076288874,20.361936322027653,19.779101583626115,-1.2350326097119542
24,2020-10-07,235000.0,1500.0,257835,82942,103849,-20907,79784,63812,15972,4935,95109,90174,36.887544359764966,-25.782666403123777,34.97352958287277,15.194427999246656
25,2020-10-06,233500.0,-2500.0,309606,78408,128639,-50231,98621,79679,18942,31289,132577,101288,42.82119855558355,5.933654195818583,32.715128259788244,-2.2584013230845272
26,2020-10-05,236000.0,6000.0,471265,179022,130770,48252,117120,176386,-59266,11014,175123,164109,37.16019649241934,-5.6610020631642115,34.82308255440145,2.107954294613208
27,2020-09-29,230000.0,5000.0,421193,146819,99590,47229,107553,210140,-102587,55358,166821,111463,39.606783588521175,2.446587096101837,26.463640183953675,-8.359442370447777
28,2020-09-28,225000.0,3000.0,197119,64336,53218,11118,53362,88078,-34716,23598,79421,55823,40.29089027440278,0.6841066858816021,28.31944155560854,1.8558013716548665
29,2020-09-25,222000.0,1000.0,340801,95154,106045,-10891,136844,140766,-3922,14813,108803,93990,31.925669232191222,-8.365221042211555,27.57914442739311,-0.7402971282154311
30,2020-09-24,221000.0,-7000.0,481274,122098,192382,-70284,148387,149648,-1261,71545,210789,139244,43.79812747000669,11.872458237815469,28.932375320503496,1.3532308931103856
31,2020-09-23,228000.0,-6000.0,411626,152441,182301,-29860,22398,73554,-51156,81016,236787,155771,57.52479192276484,13.72666445275815,37.84284763353141,8.910472313027917
32,2020-09-22,234000.0,-8500.0,408883,73941,165578,-91637,120671,73989,46682,44955,214271,169316,52.40398842700724,-5.120803495757599,41.40940073321708,3.5665530996856702
33,2020-09-21,242500.0,2500.0,425049,185230,156226,29004,76081,56743,19338,-48342,163738,212080,38.52214685836221,-13.88184156864503,49.89542382172408,8.486023088506997
34,2020-09-18,240000.0,-2000.0,465237,125968,141353,-15385,204603,165967,38636,-23251,134666,157917,28.945677149495847,-9.576469708866366,33.943345004804,-15.952078816920078
35,2020-09-17,242000.0,-500.0,592993,206701,174145,32556,124701,91871,32830,-65386,261591,326977,44.11367419176955,15.1679970422737,55.1401112660689,21.196766261264898
36,2020-09-16,242500.0,8500.0,658710,215338,159219,56119,210711,69836,140875,-196994,232661,429655,35.32070258535623,-8.792971606413317,65.22673103490155,10.086619768832648
37,2020-09-15,234000.0,1500.0,306934,84157,111154,-26997,94991,44851,50140,-23143,127786,150929,41.6330546632175,6.31235207786127,49.17311213485635,-16.053618900045194
38,2020-09-14,232500.0,6500.0,417530,161295,128920,32375,59460,39216,20244,-52619,196775,249394,47.12835005867842,5.495295395460921,59.73079778698537,10.557685652129017
39,2020-09-11,226000.0,2000.0,236329,90582,82095,8487,35236,68299,-33063,24576,110511,85935,46.761506205332395,-0.3668438533460261,36.36244388119951,-23.36835390578586
40,2020-09-10,224000.0,500.0,335130,155839,198467,-42628,58677,61260,-2583,45211,120614,75403,35.99021275325993,-10.771293452072463,22.49962701041387,-13.86281687078564
41,2020-09-09,223500.0,-2000.0,260718,77342,103445,-26103,56821,62473,-5652,31755,126555,94800,48.540952293282395,12.550739540022462,36.36112581409799,13.861498803684118
42,2020-09-08,225500.0,0.0,279719,76243,113277,-37034,17950,49701,-31751,68785,185526,116741,66.32584844075662,17.78489614747422,41.735098438075354,5.373972623977366
43,2020-09-07,225500.0,-4500.0,272841,45942,82554,-36612,15477,80448,-64971,101583,211422,109839,77.48908705069985,11.163238609943235,40.25751261723861,-1.4775858208367438
44,2020-09-04,230000.0,-3500.0,442319,76649,186724,-110075,112227,64903,47324,62751,253443,190692,57.2986916682304,-20.190395382469454,43.111871748670076,2.8543591314314654
45,2020-09-03,233500.0,-2000.0,425972,110871,118301,-7430,122542,175669,-53127,60557,192559,132002,45.204614387800135,-12.094077280430263,30.988421774201118,-12.123449974468958
46,2020-09-02,235500.0,-3000.0,564954,170458,137685,32773,115207,212558,-97351,64578,279289,214711,49.435706269891,4.231091882090865,38.005041118391944,7.016619344190826
47,2020-09-01,238500.0,14500.0,915042,387291,174277,213014,163668,144912,18756,-231770,364083,595853,39.78866543830775,-9.647040831583247,65.11755744545059,27.112516327058643
48,2020-08-31,224000.0,-2000.0,805029,332783,203906,128877,140140,356823,-216683,87806,332106,244300,41.25391756073384,1.4652521224260866,30.3467328506178,-34.77082459483279
49,2020-08-28,226000.0,9000.0,778178,356650,144729,211921,176534,210201,-33667,-178254,244994,423248,31.48302830457813,-9.770889256155709,54.389612659314444,24.042879808696643
50,2020-08-27,217000.0,-6500.0,322599,88826,104976,-16150,31820,77170,-45350,61500,201953,140453,62.60186795371343,31.1188396491353,43.53795269049191,-10.851659968822531
51,2020-08-26,223500.0,4000.0,345505,118942,119253,-311,86004,50067,35937,-35626,140559,176185,40.682189838063124,-21.919678115650306,50.9934733216596,7.455520631167687
52,2020-08-25,219500.0,2500.0,377235,147220,149952,-2732,84449,52800,31649,-28917,145566,174483,38.58761779792437,-2.0945720401387504,46.25313133723011,-4.740341984429492
53,2020-08-24,217000.0,6000.0,295989,117794,118123,-329,88402,53301,35101,-34772,89793,124565,30.3366003466345,-8.251017451289872,42.08433421512286,-4.16879712210725
54,2020-08-21,211000.0,6500.0,392349,118790,127795,-9005,154308,103855,50453,-41448,119251,160699,30.39411340413764,0.057513057503140175,40.95817754091383,-1.126156674209028
55,2020-08-20,204500.0,-12500.0,519337,176656,199303,-22647,45395,117716,-72321,94968,297286,202318,57.243369912022445,26.849256507884803,38.956977839052485,-2.0011997018613457
56,2020-08-19,217000.0,2500.0,369044,122861,88751,34110,86473,148360,-61887,27777,159710,131933,43.276682455208594,-13.966687456813851,35.74993767680819,-3.207040162244297
57,2020-08-18,214500.0,-9500.0,535693,198906,163030,35876,104746,138230,-33484,-2392,232041,234433,43.316041090699336,0.0393586354907427,43.76256549926917,8.012627822460985
58,2020-08-14,224000.0,-4000.0,462365,148029,148308,-279,48892,131122,-82230,82509,265444,182935,57.41005482681432,14.09401373611498,39.56506223438193,-4.197503264887246
59,2020-08-13,228000.0,-1500.0,983401,352588,338465,14123,115203,199146,-83943,69820,515610,445790,52.43130726936418,-4.978747557450134,45.33145685229118,5.766394617909256
60,2020-08-12,229500.0,-9500.0,604103,141425,220607,-79182,71288,154580,-83292,162474,391390,228916,64.78862048359304,12.357313214228853,37.893538022489544,-7.437918829801639
61,2020-08-11,239000.0,1000.0,626321,188158,185256,2902,70388,158048,-87660,84758,367775,283017,58.71988964125424,-6.068730842338795,45.187212308065675,7.293674285576131
62,2020-08-10,238000.0,14500.0,1265411,406267,331933,74334,145225,183196,-37971,-36363,713919,750282,56.41795432472138,-2.3019353165328624,59.291566139380805,14.10435383131513
63,2020-08-07,223500.0,1000.0,635205,231494,183579,47915,59326,103289,-43963,-3952,344385,348337,54.21635534984769,-2.20159897487369,54.83851669933328,-4.453049440047522
64,2020-08-06,222500.0,10000.0,831406,324758,139028,185730,113074,78363,34711,-220441,393574,614015,47.33836416864925,-6.877991181198439,73.85260630786884,19.014089608535556
65,2020-08-05,212500.0,4500.0,435388,151471,140267,11204,89001,100974,-11973,769,194916,194147,44.76834455703878,-2.570019611610469,44.591720488391964,-29.260885819476876
66,2020-08-04,208000.0,2000.0,371368,121331,95968,25363,65509,128358,-62849,37486,184528,147042,49.68871846793477,4.920373910895989,39.594687749079085,-4.997032739312878
67,2020-08-03,206000.0,500.0,292704,77332,113107,-35775,91844,113466,-21622,57397,123528,66131,42.202361429977046,-7.486357037957724,22.593131627856128,-17.001556121222958
68,2020-07-31,205500.0,-7500.0,386250,72674,181375,-108701,43568,113505,-69937,178638,270008,91370,69.90498381877023,27.702622388793188,23.655663430420713,1.0625318025645853
69,2020-07-30,213000.0,1000.0,399720,155571,131602,23969,65954,73038,-7084,-16885,178195,195080,44.57995596917843,-25.325027849591805,48.80416291403983,25.148499483619116
70,2020-07-29,212000.0,8000.0,557688,230901,124388,106513,136292,168134,-31842,-74671,190495,265166,34.15798797894163,-10.421967990236801,47.54737415902799,-1.25678875501184
71,2020-07-28,204000.0,500.0,333839,74649,166435,-91786,69630,76925,-7295,99081,189560,90479,56.78186191547423,22.623873936532604,27.102585377981605,-20.444788781046384
72,2020-07-27,203500.0,0.0,394211,135921,169442,-33521,75436,94683,-19247,52768,182854,130086,46.384804077004446,-10.397057838469784,32.999079173336106,5.896493795354502
73,2020-07-24,203500.0,-8000.0,566590,174686,263670,-88984,57460,129943,-72483,161467,334444,172977,59.02751548738947,12.642711410385026,30.52948340069539,-2.469595772640716
74,2020-07-23,211500.0,500.0,511415,199734,216375,-16641,90718,153480,-62762,79403,220963,141560,43.20620239922568,-15.821313088163791,27.680064135780142,-2.849419264915248
75,2020-07-22,211000.0,-6000.0,386754,128134,152083,-23949,51223,107392,-56169,80118,207397,127279,53.62504330918362,10.418840909957936,32.90954973962778,5.229485603847635
76,2020-07-21,217000.0,-7000.0,558469,185694,169231,16463,83320,232430,-149110,132647,289455,156808,51.83009262823899,-1.7949506809446305,28.078192343711112,-4.831357395916665
77,2020-07-20,224000.0,3500.0,434885,216765,147001,69764,53505,76373,-22868,-46896,164615,211511,37.8525357278361,-13.977556900402888,48.63607620405395,20.557883860342837
78,2020-07-17,220500.0,7500.0,436200,172367,121609,50758,83546,75428,8118,-58876,180287,239163,41.331270059605686,3.478734331769587,54.828748280605225,6.1926720765512755
79,2020-07-16,213000.0,-2500.0,402205,159094,140213,18881,92572,107736,-15164,-3717,150539,154256,37.42842580276227,-3.902844256843416,38.35258139505973,-16.476166885545496
80,2020-07-15,215500.0,5500.0,815163,335446,175035,160411,162755,194663,-31908,-128503,316962,445465,38.88326629152697,1.4548404887647024,54.64735273804134,16.294771342981612
81,2020-07-14,210000.0,5500.0,549007,161253,143429,17824,140606,148686,-8080,-9744,247148,256892,45.01727664674585,6.1340103552188765,46.792117404696114,-7.855235333345227
82,2020-07-13,204500.0,12000.0,416475,194764,81503,113261,65148,31157,33991,-147252,156563,303815,37.59241250975449,-7.42486413699136,72.94915661204155,26.157039207345434
83,2020-07-10,192500.0,-5000.0,280706,77700,139516,-61816,32042,65319,-33277,95093,170964,75871,60.90500381181735,23.312591302062863,27.028634941896502,-45.92052167014505
84,2020-07-09,197500.0,-1500.0,299020,151118,132451,18667,42087,83721,-41634,22967,105815,82848,35.38726506588188,-25.517738745935475,27.706507925891245,0.6778729839947424
85,2020-07-08,199000.0,-2000.0,271449,114649,84475,30174,69859,134343,-64484,34310,86941,52631,32.02848417198074,-3.358780893901134,19.38890915052183,-8.317598775369415
86,2020-07-07,201000.0,-3500.0,352141,106981,93407,13574,101433,144472,-43039,29465,143727,114262,40.81518482653255,8.786700654551808,32.447797899136994,13.058888748615164
87,2020-07-06,204500.0,9000.0,336074,151800,66611,85189,41736,31177,10559,-95748,142538,238286,42.41268292102335,1.5974980944907955,70.902836875212,38.45503897607501
88,2020-07-03,195500.0,1000.0,165056,80201,60401,19800,14395,47238,-32843,13043,70460,57417,42.68854207056999,0.2758591495466405,34.78637553315239,-36.116461342059615
89,2020-07-02,194500.0,500.0,253093,97881,58862,39019,88406,130853,-42447,3428,66806,63378,26.39583078157041,-16.292711288999577,25.04138794830359,-9.744987584848797
90,2020-07-01,194000.0,2000.0,173150,75583,54982,20601,30797,33863,-3066,-17535,66770,84305,38.5619405140052,12.16610973243479,48.68899797863124,23.64761003032765
91,2020-06-30,192000.0,0.0,253317,90653,57959,32694,81282,115078,-33796,1102,81382,80280,32.12654500092769,-6.435395513077509,31.69151695306671,-16.997481025564532
92,2020-06-29,192000.0,-6500.0,212889,65095,90757,-25662,21117,48147,-27030,52692,126677,73985,59.50377896462476,27.377233963697066,34.75285242544236,3.061335472375653
93,2020-06-26,198500.0,4500.0,295836,90617,94752,-4135,57234,62620,-5386,9521,147985,138464,50.02264768317581,-9.481131281448945,46.80431049635609,12.051458070913725
94,2020-06-25,194000.0,-11000.0,392726,82161,176895,-94734,56654,82977,-26323,121057,253911,132854,64.65347341403421,14.630825730858398,33.828674444778294,-12.975636051577794
95,2020-06-24,205000.0,12000.0,734730,231189,136907,94282,112287,158637,-46350,-47932,391254,439186,53.25139847290842,-11.40207494112579,59.77515549929906,25.946481054520767
96,2020-06-23,193000.0,9000.0,579311,219641,131474,88167,101926,176962,-75036,-13131,257744,270875,44.49147349178593,-8.759924981122488,46.75813164258921,-13.017023856709848
97,2020-06-22,184000.0,-1500.0,204828,51990,86831,-34841,45559,68598,-23039,57880,107279,49399,52.37516355185814,7.883690060072205,24.117308180522194,-22.64082346206702
98,2020-06-19,185500.0,-2500.0,319737,88171,78068,10103,104453,199517,-95064,84961,127113,42152,39.75548654050047,-12.619677011357666,13.183335053497093,-10.933973127025101
99,2020-06-18,188000.0,-2000.0,282466,82586,91454,-8868,87837,122671,-34834,43702,112043,68341,39.66601290066769,-0.08947363983278223,24.194416319132213,11.01108126563512
100,2020-06-17,190000.0,-5000.0,316584,73831,121109,-47278,113264,126545,-13281,60559,129489,68930,40.90194071715564,1.2359278164879512,21.77305233366184,-2.4213639854703715
101,2020-06-16,195000.0,8000.0,322656,140129,98743,41386,50963,67507,-16544,-24842,131564,156406,40.77531488644253,-0.12662583071310962,48.47453634830903,26.70148401464719
102,2020-06-15,187000.0,-19000.0,594810,115344,260292,-144948,56807,196078,-139271,284219,422659,138440,71.0578167818295,30.28250189538697,23.274659134849784,-25.199877213459246
103,2020-06-12,206000.0,0.0,440380,228164,185428,42736,63719,109177,-45458,2722,148497,145775,33.72019619419592,-37.33762058763358,33.1020936463963,9.827434511546514
104,2020-06-11,206000.0,-5000.0,624141,104762,338387,-233625,317915,209683,108232,125393,201464,76071,32.278603712943074,-1.4415924812528473,12.188111340226007,-20.91398230617029
105,2020-06-10,211000.0,-3500.0,338548,96015,79303,16712,91587,201112,-109525,92813,150946,58133,44.58629204721339,12.307688334270317,17.171272611269302,4.983161271043295
106,2020-06-09,214500.0,-3000.0,244881,97044,123684,-26640,49108,59233,-10125,36765,98729,61964,40.31713362817042,-4.269158419042974,25.3037189492039,8.1324463379346
107,2020-06-08,217500.0,-1500.0,285589,111222,131162,-19940,90387,75805,14582,5358,83980,78622,29.405894484731554,-10.911239143438863,27.529771804936466,2.226052855732565
108,2020-06-05,219000.0,1500.0,287283,140145,128618,11527,58331,73487,-15156,3629,88807,85178,30.912723690576886,1.5068292058453316,29.649509368810545,2.1197375638740787
109,2020-06-04,217500.0,-6500.0,408294,155367,163677,-8310,114394,125633,-11239,19549,138533,118984,33.92971731154511,3.0169936209682255,29.141745898788617,-0.5077634700219278
110,2020-06-03,224000.0,10000.0,515118,295176,148522,146654,102818,129716,-26898,-119756,117124,236880,22.737314557052947,-11.192402754492164,45.98558000302843,16.843834104239814
111,2020-06-02,214000.0,8000.0,430198,179150,113790,65360,121460,127397,-5937,-59423,129588,189011,30.122873653526984,7.3855590964740365,43.93581560118829,-2.049764401840143
112,2020-06-01,206000.0,8000.0,260640,100438,59733,40705,66922,47236,19686,-60391,93280,153671,35.78882750153468,5.6659538480077,58.9591006752609,15.02328507407261
113,2020-05-29,198000.0,7500.0,389868,102178,67386,34792,219901,178999,40902,-75694,67789,143483,17.387679932695168,-18.401147568839516,36.80296921009162,-22.15613146516928
114,2020-05-28,190500.0,-2500.0,287260,83555,92326,-8771,141672,136844,4828,3943,62033,58090,21.594722550999094,4.207042618303927,20.22209844739957,-16.580870762692047
115,2020-05-27,193000.0,-2000.0,285130,80497,87045,-6548,125833,142180,-16347,22895,78800,55905,27.636516676603655,6.041794125604561,19.606846000070142,-0.6152524473294285
116,2020-05-26,195000.0,8500.0,353343,132434,58319,74115,80678,102937,-22259,-51856,140231,192087,39.686933093339896,12.05041641673624,54.362758000016974,34.75591199994683
117,2020-05-25,186500.0,2500.0,166801,68592,71032,-2440,58500,32963,25537,-23097,39709,62806,23.806212192972463,-15.880720900367432,37.65325147930768,-16.709506520709297
118,2020-05-22,184000.0,-3000.0,255149,51571,94667,-43096,147562,93002,54560,-11464,56016,67480,21.954230665219146,-1.851981527753317,26.44729158256548,-11.205959896742197
119,2020-05-21,187000.0,2000.0,288325,74002,93178,-19176,119824,111270,8554,10622,94499,83877,32.775166912338506,10.82093624711936,29.091129801439347,2.643838218873867
120,2020-05-20,185000.0,-1500.0,251354,100983,73793,27190,75615,94368,-18753,-8437,74756,83193,29.741321005434568,-3.033845906903938,33.097941548572926,4.006811747133579
121,2020-05-19,186500.0,13500.0,632454,294433,72741,221692,145222,131480,13742,-235434,192799,428233,30.484272373959215,0.7429513685246469,67.70974647958586,34.611804931012934
122,2020-05-18,173000.0,500.0,224848,84109,66981,17128,89721,109860,-20139,3011,51018,48007,22.689995018857186,-7.794277355102029,21.35086814203373,-46.35887833755213
123,2020-05-15,172500.0,3000.0,211529,74735,59876,14859,97753,71364,26389,-41248,39041,80289,18.45657096662869,-4.2334240522284965,37.95649769062398,16.605629548590255
124,2020-05-14,169500.0,-1000.0,291779,131457,166627,-35170,108284,82380,25904,9266,52038,42772,17.834731080715198,-0.6218398859134915,14.659039889779594,-23.29745780084439
125,2020-05-13,170500.0,500.0,231167,61319,56923,4396,92944,134632,-41688,37292,76904,39612,33.26772419938832,15.43299311867312,17.13566382744942,2.4766239376698262
126,2020-05-12,170000.0,-2500.0,260081,37021,86598,-49577,127552,119468,8084,41493,95508,54015,36.722405712066625,3.454681512678306,20.768529804176392,3.632865976726972
127,2020-05-11,172500.0,-3500.0,441460,84020,107600,-23580,243370,271519,-28149,51729,114070,62341,25.839260635165136,-10.883145076901489,14.121551216418249,-6.646978587758143
128,2020-05-08,176000.0,6000.0,359076,173488,66114,107374,123214,86445,36769,-144143,62374,206517,17.37069589724738,-8.468564737917756,57.51345119139124,43.39189997497299
129,2020-05-07,170000.0,-3000.0,260282,62166,111047,-48881,116737,117445,-708,49589,81379,31790,31.265704120915004,13.895008223667624,12.213675936100076,-45.299775255291166
130,2020-05-06,173000.0,3500.0,284330,100082,57063,43019,119851,129013,-9162,-33857,64397,98254,22.648682868497872,-8.617021252417132,34.556325396546264,22.34264946044619
131,2020-05-04,169500.0,-2500.0,393505,98204,136431,-38227,216483,181696,34787,3440,78818,75378,20.029732786114536,-2.6189500823833356,19.155538049071804,-15.40078734747446
132,2020-04-29,172000.0,4500.0,330932,116627,76427,40200,126118,80539,45579,-85779,88187,173966,26.648072715844943,6.618339929730407,52.5685034992083,33.4129654501365
133,2020-04-28,167500.0,0.0,351935,83023,93557,-10534,85421,154520,-69099,79633,183491,103858,52.13775271001747,25.48967999417253,29.51056303010499,-23.057940469103308
134,2020-04-27,167500.0,-1500.0,401696,98442,121763,-23321,58708,200634,-141926,165247,244546,79299,60.87837568708675,8.740622977069279,19.741047956663746,-9.769515073441244
135,2020-04-24,169000.0,-8000.0,440277,66020,266024,-200004,130613,91966,38647,161357,243644,82287,55.33879807484834,-5.539577612238411,18.68982481483248,-1.0512231418312652
136,2020-04-23,177000.0,500.0,278640,88556,96650,-8094,83052,79543,3509,4585,107032,102447,38.4122882572495,-16.92650981759884,36.76679586563307,18.07697105080059
137,2020-04-22,176500.0,0.0,425251,109033,226675,-117642,176169,110011,66158,51484,140049,88565,32.93325588887504,-5.479032368374462,20.826523629574066,-15.940272236059005
138,2020-04-21,176500.0,-3000.0,387624,69545,147061,-77516,196063,147622,48441,29075,122016,92941,31.477927063339735,-1.4553288255353038,23.97710152106165,3.1505778914875826
139,2020-04-20,179500.0,0.0,402353,72894,115785,-42891,240403,226475,13928,28963,89056,60093,22.133797933655273,-9.344129129684461,14.935392553305181,-9.041708967756467
140,2020-04-17,179500.0,5000.0,315155,114132,63872,50260,77578,105851,-28273,-21987,123445,145432,39.169614951373134,17.03581701771786,46.14618203741016,31.210789484104982
141,2020-04-16,174500.0,-2000.0,402536,97900,93074,4826,191396,250757,-59361,54535,113240,58705,28.131645368364566,-11.037969583008568,14.58378877914025,-31.562393258269914
142,2020-04-14,176500.0,2500.0,256468,103805,68007,35798,86714,103049,-16335,-19463,65949,85412,25.714319135330722,-2.417326233033844,33.303180123836114,18.719391344695865
143,2020-04-13,174000.0,-7000.0,243078,63706,116306,-52600,38138,37746,392,52208,141234,89026,58.102337521289456,32.38801838595873,36.62445799290763,3.3212778690715155
144,2020-04-10,181000.0,3000.0,368237,92695,117417,-24722,83913,106432,-22519,47241,191629,144388,52.03958320320881,-6.06275431808065,39.2106170754161,2.5861590825084733
145,2020-04-09,178000.0,8000.0,607783,302286,138755,163531,81824,184507,-102683,-60848,223673,284521,36.8014570989975,-15.238126104211304,46.81292500777416,7.602307932358059
146,2020-04-08,170000.0,-2500.0,444216,140601,122178,18423,153890,222617,-68727,50304,149725,99421,33.70544960109496,-3.0960074979025407,22.381228951681166,-24.431696056092996
147,2020-04-07,172500.0,3000.0,600590,131715,102253,29462,302504,360621,-58117,28655,166371,137716,27.701260427246545,-6.004189173848417,22.93011871659535,0.5488897649141826
148,2020-04-06,169500.0,4500.0,301214,124864,78715,46149,70633,89735,-19102,-27047,105717,132764,35.09697424422504,7.395713816978493,44.07630455423719,21.14618583764184
149,2020-04-03,165000.0,-2000.0,307022,95184,121601,-26417,134787,132945,1842,24575,77051,52476,25.096247174469582,-10.000727069755456,17.091934779918052,-26.984369774319138
150,2020-04-02,167000.0,500.0,396835,145276,143593,1683,163853,183854,-20001,18318,87706,69388,22.10137714667305,-2.99487002779653,17.485352854460924,0.3934180745428719
151,2020-04-01,166500.0,-3000.0,362016,81289,114598,-33309,179295,181178,-1883,35192,101432,66240,28.018651109343235,5.917273962670183,18.2975338106603,0.8121809561993771
152,2020-03-31,169500.0,5000.0,409687,123055,97277,25778,152199,170439,-18240,-7538,134433,141971,32.81358695784831,4.794935848505073,34.65352818127009,16.35599437060979
153,2020-03-30,164500.0,-5500.0,446277,164024,98370,65654,86119,223627,-137508,71854,196134,124280,43.94893754327469,11.13535058542638,27.848175012380207,-6.805353168889884
154,2020-03-27,170000.0,3000.0,576106,199369,132814,66555,226695,297581,-70886,4331,150042,145711,26.04416548343534,-17.90477205983935,25.29239410802873,-2.555780904351476
155,2020-03-26,167000.0,-2500.0,658075,226746,186424,40322,146388,249761,-103373,63051,284941,221890,43.29916802796034,17.255002544525002,33.71804125669566,8.425647148666933
156,2020-03-25,169500.0,25000.0,810541,259896,215065,44831,89263,253138,-163875,119044,461382,342338,56.922721984452366,13.623553956492024,42.235741313517764,8.5177000568221
157,2020-03-24,144500.0,11000.0,464543,216982,107393,109589,95271,259245,-163974,54385,152290,97905,32.78275638638404,-24.13996559806833,21.075551671212352,-21.16018964230541
158,2020-03-23,133500.0,-7000.0,522677,148849,162022,-13173,124590,277512,-152922,166095,249238,83143,47.68489908681652,14.902142700432485,15.907147243900152,-5.1684044273122005
159,2020-03-20,140500.0,11500.0,567440,205321,173247,32074,191013,271787,-80774,48700,171106,122406,30.154025095164243,-17.530873991652278,21.571619906950517,5.664472663050365
160,2020-03-19,129000.0,-12000.0,577742,270239,204875,65364,130176,244237,-114061,48697,177327,128630,30.693112150406236,0.5390870552419926,22.264263287072776,0.6926433801222593
161,2020-03-18,141000.0,-11500.0,438595,102478,167811,-65333,150622,181498,-30876,96209,185495,89286,42.29300379621291,11.599891645806672,20.35727721474253,-1.9069860723302448
162,2020-03-17,152500.0,-9000.0,433323,155383,123953,31430,140859,224316,-83457,52027,137081,85054,31.634831292130812,-10.658172504082096,19.628314213646632,-0.7289630010958987
163,2020-03-16,161500.0,-10000.0,329732,93228,133792,-40564,117125,151841,-34716,75280,119379,44099,36.20485727803185,4.57002598590104,13.374194800625963,-6.254119413020669
164,2020-03-13,171500.0,-8500.0,623997,258908,172318,86590,284614,392772,-108158,21568,80475,58907,12.896696618733744,-23.30816065929811,9.440269744886594,-3.933925055739369
165,2020-03-12,180000.0,-7500.0,458209,194196,210767,-16571,214661,192692,21969,-5398,49352,54750,10.770630869319458,-2.126065749414286,11.948695900778903,2.508426155892309
166,2020-03-11,187500.0,-1500.0,288950,106222,130045,-23823,133106,125543,7563,16260,49622,33362,17.17321335871258,6.402582489393122,11.545942204533656,-0.40275369624524693
167,2020-03-10,189000.0,-5000.0,392442,175785,135822,39963,128535,220875,-92340,52377,88122,35745,22.45478312718822,5.2815697684756415,9.108352317030286,-2.4375898875033695
168,2020-03-09,194000.0,-9000.0,237798,102301,101166,1135,78102,105778,-27676,26541,57395,30854,24.136031421626758,1.6812482944385359,12.974877837492324,3.8665255204620372
169,2020-03-06,203000.0,-7500.0,248997,79562,99827,-20265,110164,133060,-22896,43161,59271,16110,23.80390125182231,-0.3321301698044472,6.469957469367101,-6.504920368125223
170,2020-03-05,210500.0,1500.0,244377,74520,101113,-26593,127385,129423,-2038,28631,42472,13841,17.379704309325344,-6.424196942496966,5.663789963867304,-0.806167505499797
171,2020-03-04,209000.0,4500.0,249704,82028,97814,-15786,148276,125240,23036,-7250,19400,26650,7.769198731297856,-9.610505578027489,10.672636401499375,5.008846437632071
172,2020-03-03,204500.0,-2500.0,302640,88355,125249,-36894,152460,157709,-5249,42143,61825,19682,20.42856198784034,12.659363256542484,6.503436426116839,-4.1691999753825355
173,2020-03-02,207000.0,-3000.0,558902,179759,159940,19819,302348,350974,-48626,28807,76795,47988,13.740333725769455,-6.688228262070885,8.586120643690665,2.082684217573825
174,2020-02-28,210000.0,-9000.0,317745,127830,111120,16710,152109,174783,-22674,5964,37806,31842,11.898220270972006,-1.842113454797449,10.02124344993627,1.4351228062456052
175,2020-02-27,219000.0,-1000.0,162109,108744,94730,14014,39815,48937,-9122,-4892,13550,18442,8.358573552362916,-3.53964671860909,11.376296195769513,1.3550527458332429
176,2020-02-26,220000.0,0.0,234909,107814,108975,-1161,107571,104014,3557,-2396,19524,21920,8.311303526046256,-0.04727002631666011,9.331272961018948,-2.0450232347505644
177,2020-02-25,220000.0,1000.0,249318,136674,113015,23659,83398,112765,-29367,5708,29246,23538,11.730400532653078,3.4190970066068225,9.440954925035497,0.1096819640165485
178,2020-02-24,219000.0,-9500.0,247956,119804,109112,10692,82608,111694,-29086,18394,45544,27150,18.367774927809773,6.637374395156694,10.949523302521415,1.5085683774859184
179,2020-02-21,228500.0,-2500.0,143419,67306,103230,-35924,55066,22334,32732,3192,21047,17855,14.675182507199185,-3.6925924206105876,12.449535975010285,1.5000126724888698
180,2020-02-20,231000.0,-4500.0,183854,68572,112679,-44107,78330,55013,23317,20790,36952,16162,20.098556463280648,5.423373956081463,8.790670858398512,-3.658865116611773
181,2020-02-19,235500.0,0.0,158389,69299,70122,-823,71632,70513,1119,-296,17458,17754,11.022230079109029,-9.076326384171619,11.209111743871102,2.41844088547259
182,2020-02-18,235500.0,-3500.0,126287,61369,89260,-27891,33116,26297,6819,21072,31802,10730,25.18232280440584,14.16009272529681,8.496519831811668,-2.712591912059434
183,2020-02-17,239000.0,2000.0,119699,68472,67937,535,29847,29873,-26,-509,21380,21889,17.861469185206225,-7.320853619199614,18.28670247871745,9.790182646905784
184,2020-02-14,237000.0,-2000.0,186275,92930,92605,325,52407,72001,-19594,19269,40938,21669,21.977184270567708,4.115715085361483,11.632800966313246,-6.653901512404206
185,2020-02-13,239000.0,-3500.0,252113,119795,121154,-1359,93992,110005,-16013,17372,38326,20954,15.201913427709005,-6.775270842858703,8.311352449100205,-3.3214485172130406
186,2020-02-12,242500.0,5000.0,268281,106102,81500,24602,137202,128650,8552,-33154,24977,58131,9.310014499722307,-5.8918989279866985,21.66795263175551,13.356600182655306
187,2020-02-11,237500.0,9000.0,302565,159408,82820,76588,99612,142641,-43029,-33559,43545,77104,14.39194883743989,5.081934337717582,25.48344983722506,3.8154972054695477
188,2020-02-10,228500.0,-2500.0,183144,76112,85996,-9884,73077,88295,-15218,25102,33955,8853,18.5400559122876,4.14810707484771,4.83390119250426,-20.6495486447208
189,2020-02-07,231000.0,-3000.0,232094,60002,107062,-47060,136245,103311,32934,14126,35847,21721,15.445035201254665,-3.0950207110329337,9.35870810964523,4.52480691714097
190,2020-02-06,234000.0,7000.0,311850,153663,74878,78785,111614,189791,-78177,-608,46573,47181,14.934423601090268,-0.5106116001643972,15.129389129389128,5.770681019743899
191,2020-02-05,227000.0,-2500.0,255446,80969,167995,-87026,127537,67381,60156,26870,46940,20070,18.375703671226013,3.441280070135745,7.856846456785386,-7.272542672603742
192,2020-02-04,229500.0,1500.0,376956,78245,140779,-62534,257517,218980,38537,23997,41194,17197,10.928065875062341,-7.447637796163672,4.562070904827088,-3.294775551958298
193,2020-02-03,228000.0,-1500.0,332333,116317,127345,-11028,183418,177615,5803,5225,32598,27373,9.808836317789686,-1.1192295572726554,8.236618090890763,3.674547186063675
194,2020-01-31,229500.0,-7500.0,238669,94606,100310,-5704,86350,92407,-6057,11761,57713,45952,24.181188172741326,14.37235185495164,19.253443052931047,11.016824962040284
195,2020-01-30,237000.0,-2500.0,393045,176229,178632,-2403,134641,175212,-40571,42974,82175,39201,20.90727524838123,-3.273912924360097,9.973667137350684,-9.279775915580363
196,2020-01-29,239500.0,-5500.0,310470,114181,200879,-86698,87425,77147,10278,76420,108864,32444,35.06425741617548,14.15698216779425,10.449962959384159,0.47629582203347454
197,2020-01-28,245000.0,-6500.0,283811,138044,125110,12934,106356,116168,-9812,-3122,39411,42533,13.88635394681672,-21.17790346935876,14.986381782242407,4.5364188228582485
198,2020-01-23,251500.0,6000.0,472880,195160,142473,52687,204639,230232,-25593,-27094,73081,100175,15.454449331754356,1.5680953849376351,21.184021316190154,6.197639533947747
199,2020-01-22,245500.0,4500.0,283895,149293,85702,63591,98113,164784,-66671,3080,36489,33409,12.852991422885221,-2.6014579088691345,11.768083270223146,-9.415938045967009
200,2020-01-21,241000.0,-5000.0,252264,84708,119768,-35060,89431,115318,-25887,60947,78125,17178,30.96953984714426,18.11654842425904,6.809532870326325,-4.958550399896821
201,2020-01-20,246000.0,-2000.0,150631,68035,98802,-30767,61173,37356,23817,6950,21423,14473,14.222172062855588,-16.747367784288674,9.608247970205335,2.7987150998790105
202,2020-01-17,248000.0,-1500.0,162761,65891,84218,-18327,78721,61249,17472,855,18149,17294,11.150705635871,-3.0714664269845873,10.625395518582462,1.0171475483771264
203,2020-01-16,249500.0,4500.0,291549,110735,83016,27719,151016,172122,-21106,-6613,29798,36411,10.22058041701395,-0.9301252188570501,12.48880977125629,1.863414252673829
204,2020-01-15,245000.0,1000.0,176379,65443,70536,-5093,90562,91910,-1348,6441,20374,13933,11.55126177152609,1.330681354512139,7.89946648977486,-4.589343281481431
205,2020-01-14,244000.0,2000.0,192654,48046,102990,-54944,99074,73695,25379,29565,45534,15969,23.635117879722195,12.083856108196105,8.28895325298203,0.38948676320716924
206,2020-01-13,242000.0,-2500.0,199412,54652,75085,-20433,93467,111233,-17766,38199,51293,13094,25.722123041742723,2.087005162020528,6.566304936513349,-1.72264831646868
207,2020-01-10,244500.0,-500.0,208838,76054,90921,-14867,107000,109635,-2635,17502,25784,8282,12.346412051446576,-13.375710990296147,3.965753359063006,-2.6005515774503434
208,2020-01-09,245000.0,0.0,283999,114704,148404,-33700,136742,122780,13962,19738,32553,12815,11.462364304099662,-0.8840477473469139,4.512339832182508,0.5465864731195018
209,2020-01-08,245000.0,-7500.0,317886,138258,179186,-40928,135232,121526,13706,27222,44396,17174,13.966012973204231,2.503648669104569,5.402565699653334,0.8902258674708268
210,2020-01-07,252500.0,3000.0,251361,81721,94586,-12865,156389,127176,29213,-16348,13251,29599,5.271700860515354,-8.694312112688877,11.775494209523355,6.372928509870021
211,2020-01-06,249500.0,-500.0,130109,47972,91637,-43665,67289,21756,45533,-1868,14848,16716,11.411969963645866,6.140269103130512,12.847689245171356,1.0721950356480008
212,2020-01-03,250000.0,2500.0,255475,74194,168206,-94012,137220,64259,72961,21051,44061,23010,17.246697328505725,5.834727364859859,9.006752128388296,-3.84093711678306
213,2020-01-02,247500.0,-8500.0,214585,58604,131587,-72983,96562,77698,18864,54119,59419,5300,27.690192697532446,10.44349536902672,2.4698837290584152,-6.536868399329881
214,2019-12-30,256000.0,-1500.0,106749,46008,40037,5971,51384,61283,-9899,3928,9357,5429,8.765421690132928,-18.924771007399517,5.085761927512202,2.6158781984537867
215,2019-12-27,257500.0,-3500.0,106529,48118,68904,-20786,35389,28249,7140,13646,23022,9376,21.61101671845225,12.845595028319323,8.801359254287565,3.715597326775363
216,2019-12-26,261000.0,3500.0,126392,51732,39453,12279,65371,43184,22187,-34466,9289,43755,7.349357554275588,-14.261659164176663,34.61848851193113,25.81712925764357
217,2019-12-24,257500.0,-2500.0,161771,77550,51745,25805,74097,92439,-18342,-7463,10124,17587,6.258229225262872,-1.0911283290127152,10.871540634600763,-23.74694787733037
218,2019-12-23,260000.0,-2000.0,204087,62020,54254,7766,133583,142989,-9406,1640,8484,6844,4.15705066956739,-2.1011785556954825,3.353471803691563,-7.5180688309092
219,2019-12-20,262000.0,1000.0,242192,37743,44896,-7153,197703,182514,15189,-8036,6746,14782,2.7853934068837947,-1.3716572626835952,6.10342207835106,2.749950274659497
220,2019-12-19,261000.0,-6000.0,250200,61376,89730,-28354,133752,143671,-9919,38273,55072,16799,22.01119104716227,19.225797640278476,6.714228617106315,0.6108065387552548
221,2019-12-18,267000.0,3500.0,317144,59548,96144,-36596,228642,184203,44439,-7843,28954,36797,9.129606740155891,-12.88158430700638,11.602615846429382,4.888387229323067
222,2019-12-17,263500.0,3000.0,540074,81053,104447,-23394,419317,393059,26258,-2864,39704,42568,7.35158515314568,-1.778021587010211,7.881882853090502,-3.7207329933388795
223,2019-12-16,260500.0,0.0,234196,85607,67028,18579,116587,145984,-29397,10818,32002,21184,13.664622794582314,6.313037641436634,9.04541495157902,1.163532098488517
224,2019-12-13,260500.0,1000.0,243561,89750,80099,9651,116078,138964,-22886,13235,37733,24498,15.492217555355742,1.8275947607734278,10.058260558956484,1.0128456073774643
225,2019-12-12,259500.0,3500.0,409684,212553,204842,7711,164361,174895,-10534,2823,32770,29947,7.998847892522042,-7.4933696628337,7.3097802208531455,-2.748480338103338
226,2019-12-11,256000.0,-1000.0,278919,75910,84769,-8859,163334,187928,-24594,33453,39675,6222,14.224559818441913,6.225711925919871,2.2307551654781497,-5.079025055374996
227,2019-12-10,257000.0,5000.0,287466,75049,71510,3539,181268,178461,2807,-6346,31149,37495,10.835716223831687,-3.3888435946102256,13.043281640263544,10.812526474785393
228,2019-12-09,252000.0,5500.0,244462,45079,68012,-22933,167712,157472,10240,12693,31671,18978,12.955387749425268,2.1196715255935814,7.763169735991688,-5.280111904271856
229,2019-12-06,246500.0,1500.0,200593,50591,40254,10337,115612,155705,-40093,29756,34390,4634,17.14416754323431,4.188779793809042,2.310150404051986,-5.453019331939702
230,2019-12-05,245000.0,-4500.0,298932,88776,92751,-3975,173445,199847,-26402,30377,36711,6334,12.280719360924893,-4.863448182309417,2.1188765337936384,-0.1912738702583474
231,2019-12-04,249500.0,1500.0,345433,75353,81130,-5777,236916,246497,-9581,15358,33164,17806,9.600704043910108,-2.680015317014785,5.154689910923392,3.0358133771297537
232,2019-12-03,248000.0,1500.0,262440,67878,69799,-1921,161074,181123,-20049,21970,33488,11518,12.760249961896053,3.1595459179859446,4.388812680993751,-0.7658772299296412
233,2019-12-02,246500.0,1500.0,242207,68543,76887,-8344,137360,152847,-15487,23831,36304,12473,14.988831866956776,2.2285819050607234,5.149727299376154,0.7609146183824027
234,2019-11-29,245000.0,-6000.0,257744,58976,80375,-21399,146411,168981,-22570,43969,52357,8388,20.31356695015209,5.324735083195314,3.254391954807871,-1.8953353445682826
235,2019-11-28,251000.0,-1500.0,225680,65240,72852,-7612,129812,140468,-10656,18268,30628,12360,13.571428571428571,-6.742138378723519,5.476781283232897,2.2223893284250256
236,2019-11-27,252500.0,5500.0,308263,76441,92666,-16225,197213,185064,12149,4076,34609,30533,11.227101533430869,-2.3443270379977026,9.904853972095257,4.42807268886236
237,2019-11-26,247000.0,-10000.0,630562,123410,102592,20818,442379,520610,-78231,57413,64773,7360,10.272265058788827,-0.9548364746420415,1.167212740380803,-8.737641231714454
238,2019-11-25,257000.0,1500.0,304028,89039,81253,7786,189384,212441,-23057,15271,25605,10334,8.421921665109792,-1.8503433936790348,3.399029036799242,2.231816296418439
239,2019-11-22,255500.0,2500.0,257086,83360,86629,-3269,152940,162506,-9566,12835,20786,7951,8.08523217911516,-0.3366894859946328,3.0927393945994726,-0.3062896421997694
240,2019-11-21,253000.0,-3000.0,385166,135391,143442,-8051,224384,226850,-2466,10517,25391,14874,6.592222574162829,-1.4930096049523307,3.8617115737110757,0.7689721791116031
241,2019-11-20,256000.0,-1000.0,270526,75954,78184,-2230,171968,180993,-9025,11255,22604,11349,8.355573955922905,1.763351381760076,4.195160539097905,0.3334489653868298
242,2019-11-19,257000.0,1500.0,290124,51436,96515,-45079,208753,168948,39805,5274,29935,24661,10.318001957783569,1.9624280018606637,8.500158552894623,4.304998013796718
243,2019-11-18,255500.0,-2000.0,240022,73159,62459,10700,131687,159058,-27371,16671,35176,18505,14.655323262034315,4.337321304250747,7.709709943255201,-0.7904486096394221
244,2019-11-15,257500.0,11500.0,295646,116379,103961,12418,167120,103651,63469,-75887,12147,88034,4.108629915507059,-10.546693346527256,29.776827692578284,22.06711774932308
245,2019-11-14,246000.0,4500.0,196138,105637,98717,6920,66855,84488,-17633,10713,23646,12933,12.055797448735074,7.947167533228015,6.593826795419551,-23.183000897158735
246,2019-11-13,241500.0,-3000.0,128720,31313,53762,-22449,72543,72381,162,22287,24864,2577,19.316345556246116,7.260548107511042,2.002019888129273,-4.591806907290278
247,2019-11-12,244500.0,3000.0,237741,67558,54311,13247,144396,167922,-23526,10279,25787,15508,10.846677687062813,-8.469667869183302,6.5230650161309995,4.5210451280017265
248,2019-11-11,241500.0,-500.0,109303,44633,46988,-2355,41592,53065,-11473,13828,23078,9250,21.113784617073637,10.267106930010824,8.462713740702451,1.9396487245714518
249,합계,,,93966250,32628282,31659755,968527,28548218,33482593,-4934375,3965848,32789750,28823902,34.89524164261104,13.781457025537403,30.674739068548547,22.212025327846096
